abb	abban
abbló	abból
abbu	abból
abbul	abból
abbó	abból
abbú	abból
abbúl	abból
abbüó	abból
ablakbó	ablakból
ablakjok	ablakjuk
ablakná	ablaknál
ablakosszömű	ablakosszemű
ablakátúl	ablakától
abona	gabona
abrincsba	abroncsba
abrincson	abroncson
acnielsen	acnielsen
acskó	zacskó
acélkészségéve	acélkészségével
addák	adják
addég	addig
adjonak	adjanak
adjá	adj
adjónk	adjunk
adnyi	adni
adtanak	adtak
adtá	adtál
adónk	adunk
adós	adós
adóságba	adósságba
adóságokkal	adósságokal
adóságot	adósságot
adóságát	adósságát
aelpüfölésére	elpüfölés
agatták	aggatták
aggy	adj
aggyanak	adjanak
aggyatok	adjatok
aggyig	addig
aggyisten	adjisten
aggyit	annyit
aggyon	adjon
aggyá	adj
aggyál	adjál
agygyon	adjon
agyj	adj
agyonn	agyon
agyonütnyi	agyonütni
agyonütte	agyonütötte
agyonütted	agyonütötted
agyonüttem	agyonütöttem
agyonütték	agyonütötték
agyonűtik	agyonütik
agyák	adják
ahajt	ahelyt
ahhiz	ahhoz
ahhol	ahol
ahhon	ahhoz
ahhó	ahhoz
aholl	ahol
ahon	ahol
ahonneét	ahonnét
ahoz	ahhoz
ahun	ahol
ahunn	ahol
ahunnan	ahonnan
ahunnét	ahonnan
ahuon	ahol
ahuva	ahova
ahán	ahány
airbus-szal	airbusszal
ajhaj	ajjaj
ajis	is
ajjig	alig
ajpának	apjának
ajtókot	ajtókat
ajtónáóllk	ajtónállók
ajándékokot	ajándékot
ajándíkot	ajándékot
ajánlá	ajánlja
akadott	akadt
akarattyán	akaratán
akarcsak	akárcsak
akarhogy	akárhogy
akarhol	akárhol
akarmennyit	akármennyit
akarmilyen	akármilyen
akarminyő	akármilyen
akarmit	akármit
akarónk	akarunk
akaszottt	akasztott
akasztófáhó	akasztófához
akhát	achát
akihöz	akihez
akijé	akié
akiktűl	akiktől
akiról	akiről
akirűl	akiről
akki	aki
akkinek	akinek
akkire	akire
akko	akkor
akkor-	akkor
akkorjában	akkoriban
akkorr	akkor
akkort	akkor
akkurát	akkorát
akkó	akkor
akkór	akkor
aklombul	aklomból
aklábul	akolból
akolbó	akolból
akárhunnét	akárhonnan
aképen	akképpen
alabb	alább
alaja	alája
alakjábuó	alakjából
alaku	alakú
alakúná	alakúnál
alapszabálymódosító	alapszabály-módosító
alcsonyabb	alacsonyabb
alhatik	alhat
alhatol	alhatsz
alhattá	alhattál
allyig	alig
allát	allahot
almákot	almákat
almáriom	almárium
almáriomba	almáriumba
almáriomban	almáriumban
almáriomok	almáriumok
alol	alól
alszonak	alszanak
alsó-bajom	alsóbajom
alsónémű	alsónemű
alsőbbrendű	alsóbbrendű
aludnyi	aludni
aludott	aludt
aludtejet	aludttejet
aludtejjel	aludttejjel
aludttével	aludttejjel
aludtá	aludtál
alugyál	aludj
alugyék	aludjon
alula	alóla
alunna	aludna
alunnyi	aludni
alunnál	aludnál
alunní	aludni
alutt	aludt
aluttejet	aludttejet
aluva	alva
aluvóra	alvásra
alább-alább	alább
alájja	alája
alásan	alássan
alídt	aludt
alólla	alóla
alóra	alulra
alúl	alól
amaz	amaz
ameddég	ameddig
amejjik	amelyik
amelik	amelyik
amellik	amelyik
amelliket	amelyiket
amelliknek	amelyiknek
amelyikek	amelyikek
amelyiké	amelyik
ament	áment
amibűl	amiből
amig	amíg
amihelyt	mihelyt
amijek	amijük
amijök	amijük
amikó	amikor
amiközben	miközben
amily	amilyen
amilyenöket	amilyeneket
amind	amint
aminn	amin
aminyőt	amilyet
aminő	amilyen
aminők	amilyenek
aminőkről	amilyenekről
aminőt	amilyet
amirő	amiről
amive	amivel
amivő	amivel
amiér	amiért
ammit	amit
ammód	azonmód
amost	most
amottan	amott
amro-tól	amrótól
amég	amíg
amék	amelyik
amér	amiért
amére	amerre
amért	amiért
amëllik	amelyik
amëllike	amelyik
amëlliket	amelyiket
amëly	amely
amík	amik
amíkben	amikben
amölik	amelyik
amölyik	amelyik
amörre	amerre
amőre	amerre
andersen	Andersen
andás	andrás
angyalokot	angyalokat
angyaláva	angyalával
ann	annak
anna	annak
annakis	annak
anni	adni
annya	anya
annyifelé	annyiféle
annyij	annyi
annyiér	annyiért
annyábul	anyjából
annyának	anyjának
annyát	anyját
annyátú	anyjától
annyáébul	anyjáéból
anná	annál
anyaszűlt	anyaszült
anyaszűt	anyaszült
anyiból	annyiból
anyjok	anyjuk
anyjokat	anyjukat
anyjábó	anyjából
anyjáho	anyjához
anyjáhol	anyjához
anyjátu	anyától
anyjátúl	anyjától
anynyokkom	anyukám
anynyokom	anyukám
anyukánkého	anyukánkéhoz
anyámasszon	anyámasszony
anyámot	anyámat
anyámtul	anyámtól
anyámékot	anyámékat
anyátul	anyától
anyókátúl	anyókától
anyóssa	anyósa
anyúsághoz	anyóshoz
anám	anyám
apjok	apjuk
apjokat	apjukat
apjokból	apjukból
apjokhoz	apjukhoz
apjoknak	apjuknak
apjoktól	apjuktól
apjá	apja
apjáho	apjához
apjátul	apjától
apjátó	apjától
appartmanházakat	apartmanház
aprajára	apraja
apraó	apró
apritani	aprítani
apránkint	apránként
apródonkint	apródonként
aptya	apja
apádot	apádat
apádtól4	apádtól
apádtúl	apádtól
apámtúl	apámtól
apóssa	apósa
arannyaim	aranyaim
arannyat	aranyat
arany-mérlegen	aranymérlegen
arany-szarvassal	aranyszarvassal
aranybetűkvel	aranybetűkkel
aranybló	aranyból
aranybúl	aranyból
aranyguzsalyat	aranyguzsalyt
aranygyürü	aranygyűrű
aranykulacsbó	aranykulacsból
aranykönyű	aranykönny
aranykönyűk	aranykönnyek
aranymíves	aranyműves
aranymíveseit	aranyműveseit
aranymíveshez	aranyműveshez
aranymívesit	aranyművesét
aranymívesnek	aranyművesnek
aranymívessel	aranyművessel
aranymívest	aranyművest
aranyossak	aranyosak
aranypínzt	aranypénzt
aranyrudatt	aranyrudat
aranyrózsáírt	aranyrózsáért
aranyszörü	aranyszőrű
aranyszürűmre	aranyszőrűmre
aranyszőrü	aranyszőrű
aranyval	arannyal
aranyónk	aranyunk
aranyónkot	aranyunkat
arckípit	arcképét
arcodrú	arcodról
arcu	arcú
arcunkot	arcunkat
arcza	arca
arcáho	arcához
arkangyaltokat	arkangyalotokat
arramegyen	megy
arrló	arról
arrul	arról
arráb	arrább
arrâ	arra
arró	arról
arrúl	arról
arthur	arthur
artus	arthur
arányvárból	aranyvárból
arú	arról
assony	asszony
asszonnak	asszonynak
asszonoykat	asszonyokat
asszont	asszonyt
asszontúl	asszonytól
asszony	asszony
asszony-ember	asszonyember
asszonyokot	asszonyokat
asszonyró	asszonyról
asszonytul	asszonytól
asszonyval	asszonnyal
asszuonnak	asszonynak
asz-szony	asszony
aszmondja	mondja
aszongy	mond
asztalhó	asztalhoz
asztaó	asztaltól
asztaólaó	asztaltól
asztaóra	asztalra
asztrologusok	asztrológusok
asztán	aztán
athatja	áthatja
attak	adtak
attaó	attól
attok	adtok
attul	attól
atták	adták
attúl	attól
atyjokat	atyjukat
atyjokhoz	atyjukhoz
aunye	ejnye
aval	avval
avtozaz-nak	avtozaz-nak
avva	avval
avvâ	avval
az-az	az
az-e	az
azalat	azalatt
azaóta	azóta
azelott	azelőtt
azoka	azok
azokbó	azokból
azokot	azokat
azonba	azonban
azonn	azon
azonnalt	azonnal
azontul	azontúl
azs	az
aztat	azt
aztá	aztán
azut'a	azután
azzonnal	azonnal
azáltál	azáltal
azátn	aztán
azér	azért
azét	azért
azétt	azért
azër	azért
azír	azért
azírt	azért
azótától	azóta
azúta	azóta
azútán	azután
aódalt	oldalt
aómár	már
aútvart	ótvart
bableves-csárdába	bablevescsárda
baden-württenberg	baden-württemberg
bajbúl	bajból
bajik	bajuk
bajombul	bajomból
bajucca	bajusza
bajuccán	bajuszán
bajukot	bajukat
bajuszombó	bajuszomból
bajuszábó	bajuszából
bajítsál	hajítsál
bajúk	bajuk
baktért	baktert
balrul	balról
balró	balról
balsó	bal
bamk	bank
bangalore	bangalor
bangaloréban	bangalorban
barlangjokba	barlangjukba
barátim	barátaim
barátomot	barátomat
barátságosan	barátságosan
baráttságot	barátságot
bassánál	basánál
beborittyák	beborítják
bebujjon	bebújjon
bebujni	bebújni
bebujt	bebújt
bebúj	bebújik
becsaptá	becsaptál
becsüje	becsűje
beeresztyitek	beeresztitek
befejeszte	befejezte
befelyezte	befejez
beföcskendeznél	befecskendeznél
befödelezi	befedelezi
befödte	befedte
befödték	befedték
befőttekír	befőttekért
befűtöttëk	befűtöttek
begre	bögre
begrének	bögrének
begrét	bögrét
begrével	bögrével
begyugom	bedugom
begyugta	bedugta
begyugták	bedugták
begyönnek	bejönnek
begyött	bejött
begyünni	bejönni
begyütt	bejött
begyüttek	bejöttek
begyüttem	bejöttem
begyüvök	bejövök
behatnyi	behatni
behintettík	behintették
behivatta	behívat
behivatták	behívatták
behuzza	behúzza
behítta	behívta
behítták	behívták
behúntam	behunytam
behúnyta	behunyta
behúnyva	behunyva
bejéd	beléd
bejő	bejön
bejű	bejön
bekajáltott	bekiáltott
bekajáltotta	bekiáltotta
bekeccsit	bekecsét
bekiáltonak	bekiáltanak
bekiátok	bekiáltok
bekiátott	bekiáltott
bekukkantanyi	bekukkantani
bekukkint	bekukkant
bekukkintani	bekukkantani
bekukkintott	bekukkantott
bekukucskát	bekukucskált
bekötte	bekötötte
bekötték	bekötötték
bekűdte	beküldta
belaharap	beleharap
belaktaónk	belaktunk
bele-ront	beleront
belebujsz	belebújsz
belebutt	belebújt
belebújtá	belebújtál
belebútt	belebújt
belecsubban	belecsobban
beleegyez	+
beleegyezttek	beleegyeztek
beleegyezött	belegyezett
belefogódzanak	belefogódznak
belegyeztek	beleegyeztek
belegyütt	belejött
belehajitja	belehajítja
belehanyigált	belehajigált
belehuzódott	belehúzódott
belehömbörgette	belehőbrögte
belemeritett	belemerített
belenyul	belenyúl
belepisász	belepisálsz
beletörődenyi	beletörődni
belevákta	belevágta
beleőlem	belőlem
beleőlë	belőle
belit	belét
bella-flor	Bella-Flór
belle-flór	bella-flór
belole	belőle
beléfujt	beléfújt
beléfújt	belefújt
beléfútt	beléfújt
beléhajítanni	beléhajítani
belényugodott	belenyugodott
belényől	belenő
belépök	belépek
belépött	belépett
belésuppant	belésuppan
belétett	beletett
belétette	beletette
belétettík	belétették
belétövélek	beleteszlek
beléülnek	beleülnek
beléűlök	beléülök
beléűnek	beléülnek
belë	bele
belëbolondoltam	belebolondultam
belëszeret	beleszeret
belëtësznek	beletesznek
belíp	belép
belöl	belül
belölle	belőle
belü	belű
belüle	belőle
belülle	belőle
belülrűl	belülről
belőjjek	belőjek
belől	belül
belőlle	belőle
belőlled	belőled
belőllem	belőlem
belőllik	belőlük
belőlë	belőle
belőlök	belőlük
belőrő	belülről
belűle	belőle
belűlle	belőle
belűlled	belőled
bemegyen	bemegy
bemenek	bemegyek
bemeneküt	bemenekült
bemennyi	bemenni
bemenyen	bemegy
bemén	bemegy
bemënek	bemegyek
bemëntem	bementem
bemönt	bement
bennek	bennük
bennt	benn
bennë	benne
bennök	bennük
bennünköt	bennünket
bennőtöket	benneteket
bensejében	bensejében
bentmaradt	bennmaradt
bentragadt	bennragadt
bentrő	bentről
benyitani	benyitni
benyuló	benyúló
benyőtte	benőtte
benzin-	benzin
benëzni	benézni
bepörli	bepereli
bereteszőte	bereteszelte
beretválj	borotválj
berugatta	berúgatta
berugok	berúgok
beruiházásokat	beruházásokat
berëm	bőröm
besetétedik	besötétedik
besuvadott	besuvadt
beszaladott	beszaladt
beszalatt	beszaladt
beszalattam	beszaladtam
beszegődöl	beszegődsz
beszeégess	beszélgess
beszeétek	beszéltek
beszillő	beszélő
beszédit	beszédét
beszédjiket	beszédjüket
beszédjikre	beszédjükre
beszédjire	beszédére
beszédjit	beszédét
beszédjöket	beszédjüket
beszédömöt	beszédemet
beszégetett	beszélgetett
beszégettek	beszélgettek
beszégettünk	beszélgettünk
beszégetünk	beszélgetünk
beszéjenek	beszéljenek
beszéllett	beszélt
beszélli	beszéli
beszélnyi	beszélni
beszének	beszélnek
beszényi	beszélni
beszét	beszélt
beszétek	beszéltek
beszéték	beszélték
beszëli	beszéli
beszëlni	beszélni
beszíd	beszéd
beszídet	beszédet
beszídre	beszédre
beszígetés	beszélgetés
beszíl	beszél
beszílek	beszélek
beszílgessenek	beszélgessenek
beszílgessünk	beszélgessünk
beszílgetni	beszélgetni
beszílgetnőnk	beszélgetnénk
beszílgettek	beszélgettek
beszílgetés	beszélgetés
beszílgetís	beszélgetés
beszílhetek	beszélhetek
beszíljen	beszéljen
beszíljetek	beszéljetek
beszílni	beszélni
beszílt	beszélt
beszílte	beszélte
beszínyi	beszélni
beszíttam	beszívtam
beszödés	beszedés
beszúg	besúg
besél	beszél
beséljen	beszéljen
besötátedett	besötétedett
betegsiéget	betegséget
betegöket	betegeket
beteljesedék	beteljesedik
beteljesűl	beteljesül
beteritik	beterítik
bethlehem	betlehem
betoppint	betoppant
betyárbarlangbló	betyárbarlangból
betérnyi	betérni
betévő	betevő
betönni	betenni
betőtötte	betöltötte
bevarják	bevarrják
bevartak	bevarrtak
bevezetette	bevezettette
bevinnyi	bevinni
beváltya	beváltja
bevétel-	bevétel
bezon	bizony
bezony	bizony
beállana	beállna
beállani	beállni
beállanék	beállnék
beütte	beütötte
beőröm	bőröm
beűnek	beülnek
bijony	bizony
bir	bír
biraóho	bíróhoz
birja	bírja
birkaé	birkáért
birkábó	birkából
birkáinkot	birkáinkat
birkájai	birkái
birkákot	birkákat
birkákval	birkákkal
birkózniok	birkózniuk
birni	bírni
birnának	bírnának
birom	bírom
birta	bírta
birtak	bírtak
birtuk	bírtuk
birták	bírták
birunk	bírunk
biró	bíró
biróhoz	bíróhoz
bitosat	biztosat
biza	bizony
bizben	vízben
bizon	bizony
bizonkodott	bizonykodott
bizonyittsa	bizonyítsa
bizonyossan	bizonyosan
bizonyúltak	bizonyultak
bizotság	bizottság
biztosonn	biztosan
bizza	bízza
bocsádd	bocsásd
bodakot	bodagot
boglyoson	boglyosan
boglyábúl	boglyából
bogy	hogy
bogáccsábá	pogácsába
bogáccsát	pogácsát
bokorbúl	bokorból
bolbára	bolhára
boldog-asszony	boldogasszony
boldogann	boldogan
boldogságjok	boldogságuk
boldogulnyi	boldogulni
bolgott	bolygott
bolgótűz	bolygótűz
bolháho	bolhához
bolháta	bolhát
bolog	bolyong
bolondozzonak	bolondozzanak
bolondulnyi	bolondulni
bolondúl	bolondul
bombócba	gombócba
bonya	banya
bonyához	banyához
bonyát	banyát
borgyut	borjút
borgyút	borjút
borhanyagos	porhanyós
borigatták	borogatták
borija	borítja
boritja	borítja
boritják	borítják
borju	borjú
borjuból	borjúból
borjubőr	borjúbőr
borjubőrben	borjúbőrben
borjunak	borjúnak
borjut	borjút
borjutartó	borjútartó
borjúzik	borjazik
borjúztassa	borjaztassa
bornya	borja
bornyazik	borjadzik
bornyut	borjút
bornyát	borját
bornyúzott	borjazott
bornyúztatta-e	borjaztatta
borozda	barázda
borozdában	barázdában
borsod-asbaúj-zemplán	borsod-abaúj-zemplén
bortúl	bortól
borzalmasan	borzalmas
borér	borért
bosszus	bosszús
bosszusága	bosszúsága
bosszuságtól	bosszúságtól
bosszújábúl	bosszújából
bosszúlja	bosszulja
bossóval	borsóval
boszorkánságának	boszorkányságának
boszorkánságát	boszorkányságát
boszorkány-embör	boszorkány-ember
boszorkányjait	boszorkányait
boszórkán	boszorkány
bosánat	bocsánat
botocskámÍ	botocskám
botomval	botommal
bottak	botnak
botty	bot
bougues-nél	bouygues-nél
bubos	búbos
bucsut	búcsút
bucsuzkodnak	búcsúzkodnak
bucsuzott	búcsúzott
budapesten	budapesten
bujik	bújik
bujj	bújj
bujjék	bújjék
bujni	bújni
buját-baját	búját-baját
bukkik	bukik
bukkott	bukott
bukor	bokor
bukorbó	bokorból
bukrok	bokrok
bukrot	bokrot
burogatni	borogatni
buslakodik	búslakodik
busulj	búsulj
busulnak	búsulnak
busulni	búsulni
butor	bútor
buza	búza
buzug	buzog
buzába	búzába
buzában	búzában
buzán	búzán
buzát	búzát
buzával	búzával
bácskárú	bácskáról
bámészkodol	bámészkodsz
bánatja	bánata
bánatjokat	bánatukat
bánatjába	bánatába
bánatjában	bánatában
bánatjának	bánatának
bánatónk	bánatunk
báncsa	bántsa
báncsátok	bántsátok
bántalmaztá	bántalmaztál
bántlak	bántalak
bántsonak	bántsanak
bármiből	bármi
bármifíle	bármiféle
báránhús	bárányhús
báránkáim	báránykáim
báránt	bárányt
bárányokot	bárányokat
báttya	bátyja
báttyának	bátyjának
bátyjáho	bátyjához
bátyádbúl	bátyádból
bátyámnok	bátyámnak
bátyámtul	bátyámtól
bé	be
bébujik	bebújik
bébújnak	bebújnak
bébújsz	bebújsz
bébújtatá	bebújtatja
bébúttak	bebújtak
bécsapott	becsapott
bécsapták	becsapták
bécsapódjék	becsapódjon
bécsukják	becsukják
bédobják	bedobják
bédugja	bedugja
bédugott	bedugott
bédugó	bedugó
bédőlt	bedőlt
bédőt	bedőlt
béengedik	beengedik
béengedlek	beengedlek
béengedni	beengedni
béeresztlek	beeresztelek
béesteledett	beesteledett
béfagyott	befagyott
béfaló	befaló
béfekszik	befekszik
béfogatott	befogatott
béfogja	befogja
béfogta	befogta
béfogtak	befogtak
béfut	befut
béfutott	befutott
béföldelni	beföldelni
béhallatszott	behallatszott
béhordani	behordani
béhágjak	behágjak
béhítta	behívta
béhívja	behívja
béhívjátok	behívjátok
béhúzódtak	behúzódtak
béillettek	beillettek
béjelentenné	bejelentené
béjelenteti	bejelenteti
béjelentette	bejelentette
béjutott	bejutott
béjár	bejár
béjárja	bejárja
béjárjam	bejárjam
béjártuk	bejártuk
béjön	bejön
béjönnek	bejönnek
béjöttek	bejöttek
békaással	békással
békerekennek	bekerekednek
békerítik	bekerítik
békerül	bekerül
békerülnek	bekerülnek
békerűlt	bekerült
béketűrésibűl	béketűréséből
békivel	békével
békiáltott	bekiáltott
békopogtattak	bekopogtattak
békukkintott	bekukkantott
békárló	békáról
békéredzkedtek	bekéredzkedtek
békételenkedett	békétlenkedett
békételenkedj	békétlenkedj
békóba	béklyóba
békók	béklyók
békót	béklyót
béköltöznek	beköltöznek
béköltöztek	beköltöztek
békötte	bekötötte
békőnköt	békénket
bélegöngyölgeti	belegöngyölgeti
bélepni	belepni
bélovagolt	belovagolt
bélátta	belátta
bélésit	bélését
bélíp	belép
bélódittám	belódítám
bémasérozik	bemasírozik
bémegy	bemegy
bémegyek	bemegyek
bémegyen	bemegy
bémehetsz	bemehetsz
bémenne	bemenne
bémennek	bemennek
bémenni	bemenni
bément	bement
bémentek	bementek
bémenyek	bemegyek
bémenyen	bemegy
bémenyünk	bemegyünk
bémenünk	bemegyünk
bémutatta	bemutatta
béméne	bemene
bémönyön	bemegy
bénnák	bénák
bényitott	benyitott
bényújtotta	benyújtotta
bényúl	benyúl
béníztem	benéztem
bénőtte	benőtte
béomlik	beomlik
béreked	bereked
bérendezte	berendezte
bérendezése	berendezése
bérepül	berepül
bérepűlnek	berepülnek
bérességbő	bérességből
béresök	béresek/béresük
bészalad	beszalad
bészaladt	beszaladt
bészegődik	beszegődik
bészegődtek	beszegődtek
bészállnak	beszállnak
bészállunk	beszállunk
bészállásolnak	beszállásolnak
bészállítja	beszállítja
bészámolni	beszámolni
bészökik	beszökik
bészökött	beszökött
bésétáltak	besétáltak
bésütött	besütött
bétakarta	betakarta
bétanítva	betanítva
bétapasztja	betapasztja
bétarisnyált	betarisznyált
bétarisnyáltak	betarisznyáltak
bétaszította	betaszította
bételjesült	beteljesült
bételt	betelt
bétereli	betereli
béteszi	beteszi
bétett	betett
bétette	betette
bétettík	betették
bétér	befér
bétörni	betörni
bétört	betört
bétörém	betörém
bétötte	betette
béugratott	beugratott
béugrott	beugrott
bévalósodott	bevalósodott
bévetette	bevetette
bévette	bevette
bévettetett	bevettetett
bévettetlek	bevettetlek
bévették	bevették
bévetődik	bevetődik
bévezetik	bevezetik
bévezette	bevezette
béviszem	beviszem
béviteti	beviteti
bévitte	bevitte
bévitték	bevitték
bévittík	bevitték
bévivé	bevivé
bévonva	bevonva
bévágtatott	bevágtatott
béváltotta	beváltotta
bézáratod	bezáratod
béállanék	beállnék
béállott	beállt
béárulja	beárulja
béárulták	beárulták
béér	beér
béérhet	beérhet
béérkeztek	beérkeztek
béérnek	beérnek
béírkezett	beérkezett
béírt	beírt
béírtek	beértek
béírünk	beérünk
béült	beült
béültek	beültek
béültette	beültette
béültetve	beültetve
bëgrét	bögrét
bíka	béka
bíkabűrt	békabőr
bíkakirály	békakirály
bíkaországba	bikaországba
bíkimet	békémet
bíkit	békét
bíkák	békák
bíkát	békát
bíresek	béresek
bíri	biri
bírkózni	birkózni
bírkóznom	birkóznom
bírkóztak	birkóztak
bírkózásba	birkózásba
bírálkodjál	bíráskodj
bíróho	bíróhoz
bíróskodni	bíráskodni
bíróskodott	bíráskodott
bíz	biz
bízonyosan	bizonyosan
bíztatgatta	biztatgatta
bíztatják	biztatják
bíztos	biztos
bíztosan	biztosan
bíztosonn	biztosan
bódog	boldog
bódogságba	boldogságba
bódogul	boldogul
bódogulni	boldogulni
bódogult	boldogult
bótba	boltba
böcseőletësen	becsületesen
böcsös	becses
böcsülte	becsülete
bökanyarta	bekanyarintotta
bölcso	bölcső
bölcsőbűl	bölcsőből
böndőjére	bendőjére
böndőrepedésig	bendőrepedésig
böndőt	bendőt
búborék	buborék
búbosrúl	búbosról
búcsut	búcsút
búj	bújj
bújjeék	bújjék
bújjá	bújjál
búni	bújni
búslakodol	búslakodsz
búslalkodott	búslakodott
búsoljanak	búsuljanak
búsoljon	búsuljon
búsoljonak	búsuljanak
búsoljá	búsulj
búsulkodott	búslakodott
bútt	bújt
búva	bújva
búzaírt	búzáért
búzaírért	búzáért
búzájok	búzájuk
búzámot	búzámat
búzáér	búzáért
bücsültetlek	becsültetlek
büjtjit	böjtjét
bünteténye	büntetése
büntetényt	büntetést
büri	bőre
büssengeznyi	büssengezni
bütivel	bütüjével
bütön	böjtön
bőcsőbe	bölcsőbe
bőcsőjét	bölcsőjét
bőjtben	böjtben
bőjtin	böjtjén
bőjtjéig	böjtjéig
bőjtjén	böjtjén
bőjtöl	böjtöl
bőjtöljön	böjtöljön
bőribe	bőrébe
bőriben	bőrében
bőribő	bőréből
bőriből	bőréből
bőrit	bőrét
bőrivel	bőrével
bőriért	bőréért
bőrödbűl	bőrödből
bősígesenn	bőségesen
bűntetleneket	büntetleneket
bűntetést	büntetés
bűr	bőr
bűrt	bőrt
bűrödbűl	bőrödből
california-t	californiát
cargo-bázis	cargobázis
cecilia	cecília
cedulán	cédulán
cefetű	cefetül
cigán	cigány
cigánlegén	cigánylegény
cigánnak	cigánynak
cigánpurdé	cigánypurdé
cikkázik	cikázik
cikrát	szikrát
cimborájáho	cimborájához
cipőjit	cipőjét
cipőköt	cipőket
cipőtül	cipőtől
cipőtűl	cipőtől
citroen	citroën
cl	el
compaq-ot	compaqot
constantai	constanţai
credianstalt	creditanstalt
credintanstalt	creditanstalt
creditansalt	creditanstalt
csali-mese	csalimese
csalló-közi	csallóközi
családbúl	családból
családomot	családomat
csapdáho	csapdához
csapnyi	csapni
csat	csak
csattok	csatok
cselekëttem	cselekedtem
cseleködd	cselekedd
cseleködött	cselekedett
cselédimnek	cselédeimnek
cselédinek	cselédének
cselédjitől	cselédjétől
cselédszërzeőbe	cselédszerzőbe
cselédöt	cselédet
csemegélni	csemegézni
csemetít	csemetét
csemnek	csennek
csendessen	csendesen
csendüll	csendül
csendőrökvel	csendőrökkel
csengőjök	csengőjük
csepnek	csípnek
csereg-csattog	csörög-csattog
cseregni	csörögni
cserepben	cserépben
cserepbëgrét	cserépbögrét
cserepen	cserépen
cseresnye	cseresznye
cseresznyéér	cseresznyéért
cserfamakkval	cserfamakkal
cserfáná	cserfánál
cseréjünk	cseréljünk
cseréljőnk	cseréljünk
cserélli	cseréli
csholni	csaholni
csibájuk	csibéjük
csicsija	csicsíja
csicsomálja	cicomázza
csihipuhi	csihi-puhi
csihult	csiholt
csihánbó	csihánból
csihé-puhé	csihi-puhi
csik	csík
csikaja	csikója
csikaján	csikóján
csikajára	csikójára
csikaját	csikóját
csikajával	csikójával
csikó-tojás	csikótojás
csikó-tojást	csikótojást
csikókodol	csikókodsz
csillagokbul	csillagokból
csillagoktúl	csillagoktól
csillagzásbul	csillagzásból
csillapúl	csillapul
csinlt	csinált
csinyt	csínyt
csinyájjo	csinálja
csinyának	csinálnak
csinyányi	csinálni
csinyász	csinálsz
csinyát	csinált
csinájak	csináljak
csinájj	csinálj
csinájja	csinálja
csinájjanak	csináljanak
csináljonak	csináljanak
csináljónk	csináljunk
csinállyon	csináljon
csinálmik	csinálnak
csinálniok	csinálniuk
csinálnyi	csinálni
csinának	csinálnak
csinányi	csinálni
csinát	csinált
csinátam	csináltam
csip-kártyák	chipkártyák
csipdes	csípdes
csipdosgattak	csipdesgettek
csipkebokorho	csipkebokorhoz
csipkebukor	csipkebokor
csipkebukorra	csipkebokorra
csipkebukrot	csipkebokrot
csipës	csípés
csipőjükbe	cipőjükbe
csirkezuzát	csirkezúzát
csirké	csirke
csizmadiárúl	csizmadiáról
csizmákot	csizmákat
csizsma	csizma
csizsmábó	csizmából
csizsmát	csizmát
csolnakba	csónakba
csomagga	csomaggal
csomaócskát	csomócskát
csontokbúl	csontokból
csopak-ajánlátra	csopak-ajánlatra
csorbídd	csorbítsd
csorbíjja	csorbítja
csubbanásommal	csobbanásommal
csubogott	csobogott
csucsorodjík	csucsorodjon
csucsáig	csúcsáig
csunya	csúnya
csunyán	csúnyán
csuppanásommal	csobbanásommal
csuszó	csúszó
csvargatta	csavargatta
csáltál	csináltál
csánj	csinálj
csánjon	csináljon
csánni	csenni
csánnyanak	csenjenek
csántunk	csentünk
csáttot	csatot
csépölni	csépelni
csépölnivalóbul	csépelnivalóból
csëppencsék	cseppentsék
csëppet	cseppet
csërmelybe	csemelybe
csík-toplicán	csíktapolca
csínos	csinos
csínyji	csínyjei
csípogja	csipogja
csírke	csirke
csókolnyi	csókolni
csónakbúl	csónakból
csöndéröket	csöndéreket
csöndösen	csöndesen
csöngetyü	csengettyű
csöppek	cseppek
csöppeket	cseppeket
csört	csőrt
csötlött-botlott	csetlett-botlott
csúfolódol	csúfolódsz
csúfó	csúful
csúkják	csukják
csútakokat	csutakokat
csüggyit	csüdjét
csülkit	csülkét
csürkebecsinált	csirkebecsinált
csürkebecsináltnak	csirkebecsináltnak
csődörcsikaja	csődörcsikója
csőstől	csőstül
czepelje	cipelje
czigány	cigány
czigány-legények	cigánylegények
czigány-utczára	cigányutcára
czigányok	cigányok
czimere	címere
czipelje	cipelje
czipócska	cipócska
czizmadia	csizmadia
czizmába	csizmába
czélozó	célozó
célből	célból
cípőjébe	cipőjébe
cók-mókját	cókmókját
daa-nak	daanak
daa-ról	daaról
daewoo-ba	daewooba
dagodott	dagadott
daktorok	doktorok
danuónak	danolnak
danuóva	danolva
darázst	darazsat
de.	de
debrecenyi	debreceni
debreczenben	debrecenben
debreczenyben	debrecenben
debreczenyi	debreceni
dehabzsolta	behabzsolta
derekaig	derekáig
derekul	derékül
derik	derék
derékam	derekam
derékába	derekába
derík	derék
deríkon	derékon
deszkahasidékokon	deszkahasadékokon
deszkábúl	deszkából
deébe	délben
dicsekegyik	dicsekedik
dicsërik	dicsérik
dicsírte	dicsérte
dicsőségösön	dicsőségesen
dijat	díjat
dijákok	diákok
dindár	dandár
dinomdánomnak	dínomdánomnak
dinynyeje	dinnyéje
diribdarab	dirib-darab
diribdarabokra	dirib-darabokra
diribdarabra	dirib-darabra
diszitenek	díszítenek
disznóbó	disznóból
disznódurásba	disznótúrásba
disznókot	disznókat
diuót	diót
divatodzott	divatozott
dixonís	dixon's
diélútán	délután
dobbintott	dobbantott
dobnyi	dobni
dobájják	dobálják
dogja	dobja
dogjuk	dobjuk
doh-nak	dohnak
dolgoznyi	dolgozni
dolgónk	dolgunk
dollár-válság	dollárválság
dologbaó	dologból
domboruak	domborúak
dorombúónak	dorombolnak
drb	db
drbot	darabot
dudálnyi	dudálni
dunaferr-nél	dunaferrnél
dunaferr-é	dunaferré
dungó	dongó
dungót	dongót
dupljára	duplájára
duvazd	duvaszd
dvd-lejátszókho	dvd-lejátszókhoz
déji	déli
délbe	délben
déleeti-t	délelőttit
délfele	délfelé
délfelé	délfelé
délkeletrű	délkeletről
dícsérik	dicsérik
dícsértessék	dicsértessék
díl	dél
díl-amerikába	dél-amerikába
dílben	délben
dílután	délután
dóga	dolga
dógodot	dolgodat
dógok	dolgok
dógom	dolgom
dógon	dolgon
dógot	dolgot
dógozgassá	dolgozgass
dógozik	dologzik
dógozni	dolgozni
dógozom	dolgozom
dógozott	dolgozott
dógunk	dolgunk
dógunkot	dolgunkat
dógába	dolgába
dógához	dolgához
dógára	dolgára
dógáról	dolgáról
dógát	dolgát
dóhán	dohány
döfí-döfi	döfi-döfi
döglőttek	döglődtek
dölyfössön	dölyfösen
dördűl	dördül
dúrozsol	duruzsol
düljek	dőljek
düljön	dőljön
dőtögetyi	döntögeti
dűtögetik	döntögetik
dűtötte	döntötte
eI	el
ebb	ebben
ebbben	ebben
ebbeő	ebből
ebbül	ebből
ebbő	ebből
ebbű	ebből
ebbűl	ebből
eber	ember
ebid	ebéd
ebita-eredménye	ebitda-eredménye
ebiédűnek	ebédelnek
ebnondatni	elmondatni
ebédelnyi	ebédelni
ebédhöz	ebédhez
ebédjik	ebédjük
ebédrő	ebédről
ebédöljek	ebédeljek
ebédölnek	ebédelnek
ebédölünk	ebédelünk
ebíddel	ebéddel
ebídelni	ebédelni
ebídelünk	ebédelünk
ebídet	ebédet
ebídre	ebédre
eccer	egyszer
eccerre	egyszerre
eccsik	öccsük
ecczer	egyszer
ecczör	egyszer
ecczöribe	egyszeriben
eccé	egyszer
eccör	egyszer
eccő	egyszer
eceakáján	éjszakáján
ecs	egy
ecsém	öcsém
eddegelt	eddegélt
eddegilj	eddegélj
edgyütt	együtt
edënnyel	edénnyel
edínye	edénye
eemönt	elment
effélik	effélék
egen	igen
eger	egér
egeri	egerei
egerke	egérke
egeész	egész
eggy	egy
eggyes	egyes
eggyig	egyig
eggyik	egyik
eggyiknek	egyiknek
egirke	egérke
egiész	egész
egrészt	egyrészt
egy-kettőre	egykettőre
egybe	egybe
egybü	egyből
egybő	egyből
egyebem	egyéb
egyebet	egyebet
egyebüve	egyebüvé
egyen	egyen
egyenkint	egyenként
egyet-kettot	egyet-kettőt
egyet-ketőtt	egyet-kettőt
egyett	egyet
egyfurmán	egyformán
egyikbűl	egyikből
egyiket	egyiket
egyiknek	egyiknek
egyiktek	egyikőtök
egyikteké	egyikőtöké
egyiktűl	egyiktől
egyinek	egyiknek
egyis	egyik
egykettő	egy-kettő
egymaguk	egymaga
egymáshó	egymáshoz
egymássao	egymással
egymástló	egymástól
egymástúl	egymástól
egymásval	egymással
egymáséi	egymás
egymásér	egymásért
egynéhán	egynéhány
egyrét	egyrészt
egyrűl-másrúl	egyről-másról
egyserre	egyszerre
egyszere	egyszerre
egyszr	egyszer
egyször	egyszer
egyszöribe	egyszeriben
egyszörsmind	egyszersmind
egysző	egyszer
egyuttal	egyúttal
egyébb	egyéb
egyíb	egyéb
egyík	egyék
egyíket	egyiket
együnnek	eljönnek
együttek	eljöttek
egzecéroztatja	ergzecíroztatja
egéssz	egész
egésszen	egészen
egésséget	egészséget
egészrő	egészről
egészsé	egésszé
egészég	egészen
egër	eger
egësz	egész
egëszen	egészen
egír	egér
egírnek	egérnek
egírországba	egérországba
egísszen	egészen
egísz	egész
egíszen	egészen
egött	égett
egő	égő
ehetel	ehetsz
ehetik-ihatik	ehet-ihat
ehező	éhező
ehol	ehol
ehös	éhes
ehözéssel	éhezéssel
ej-haj	ejhaj
ejféli	éjféli
ejiszen	egészen
ejjelre	éjjelre
ejtéjén	estéjén
ekezd	elkezd
ekezdte	elkezdte
ekezdtek	elkezdtek
ekezdött	elkezdett
ekközben	eközben
eképp	ekképp
eképpen	ekképpen
eköszönt	elköszönt
ekűdték	elküldték
el-el	el
el-elbujt	el-elbújt
el-elhatta	el-elhagyta
el-felhangzott	fel-felhangzott
eladnyi	eladni
elaludott	elaludt
elaluva	elaludva
elapadott	elapadt
elbeszélli	elbeszéli
elbeszílgettek	elbeszélgettek
elbeszílgetünk	elbeszélgetünk
elbeszílte	elbeszélte
elbocsájtották	elbocsátották
elbucsuzik	elbúcsúzik
elbucsuznak	elbúcsúznak
elbucsuzott	elbúcsúzott
elbucsuzék	elbúcsúzik
elbujt	elbújt
elbámút	elbámult
elbánhatik	elbánhat
elbócsúzott	elbúcsúzott
elbódu	elbódul
elbúcsozott	elbúcsúzott
elbúcsuzott	elbúcsúzott
elbúcsúzhatol	elbúcsúzhatsz
elbútt	elbújt
elbúzta	elhúzta
elcsapnyi	elcsapni
eldurogatnak	eldurrogatnak
eldósorba	eladósorba
eldölt	eldőlt
eldűl	eldől
eldűll	eldől
eldűlt	eldőlt
electolux	electrolux
eledeli	eledele
elegend	elegendő
elegendo	elegendő
elejbe	elébe
elejbek	elébük
elejbem	elébem
elejbük	elébük
elejekbe	eléjük
elejibe	elejébe
elejikbe	eléjükbe
elejitől	elejétől
elejiét	elejét
elejökbe	elejükbe
elektrolux	electrolux
elemerült	elmerült
elemésztlek	elemésztelek
elengednyi	elengedni
elengödlek	elengedlek
elerisztett	eleresztett
elestéledett	elesteledett
elezdte	elkezdte
eleé	elé
eleőtt	előtt
elfecsegre	elfecsegte
elfoganná	elfogadná
elfogasztani	elfogyasztani
elfoggyon	elfogyjon
elfordúl	elfordul
elfáradott	elfáradt
elfödje	elfedje
elfútatták	elfúvatták
elfüttik	elfűtik
elgondúni	elgondolni
elgyugta	eldugta
elgyön	eljön
elgyönnyi	eljönni
elgyössz	eljössz
elgyött	eljött
elgyöttünk	eljöttünk
elgyövök	eljövök
elgyün	eljön
elgyünnél	eljönnél
elgyüssz	eljössz
elgyütt	eljött
elgyüttek	eljöttek
elgyüttem	eljöttem
elhaggya	elhagyja
elhajítanni	elhajítani
elhaladott	elhaladt
elhannyi	elhagyni
elhanyitták	elhajították
elhanyítani	elhajítani
elhanyította	elhajította
elhasitsuk	elhasítsuk
elhatta	elhagyta
elhervadott	elhervadt
elhinnyi	elhinni
elhoznyi	elhozni
elhulnak	elhullnak
elhétani	elhajítani
elhíttak	elhítak
elhítták	elhívták
elhúnyt	elhunyt
elhült	elhűlt
elibe	elébe
elibed	elébed
elibem	elébem
elibéd	elébed
elibém	elébem
elibök	elébük
elibük	elébük
elig	alig
eligazitsa	eligazítsa
eligazodol	eligazodsz
elindullunk	elindulunk
elindúlt	elindult
elindúlás	elindulás
elinkbe	elénk
elismeröen	elismerően
eljajditotta	eljajdította
eljibe	elébe
eljuttott	eljutott
eljöttíl	eljöttél
eljő	eljön
eljű	eljön
elkesztek	elkezdtek
elkezdet	elkezdett
elkezdette	elkezdte
elkezdögeli	elkezdegeti
elkezdött	elkezdett
elkezgyi	elkezdi
elkiséri	elkíséri
elkotródol	elkotródsz
elkovártélyozták	elkvártélyozták
elkovártélyozva	elkvártélyozva
elkéredzik	elkéredzkedik
elkészitett	elkészített
elkírjem	elkérjem
elkíszítettík	elkészítették
elkíszítve	elkészítve
elkíszül	elkészül
elkíszült	elkészült
elkíszűlt	elkészült
elkódusodik	elkoldusodik
elküldé	elküldte
elküldötte	elküldte
elkől	elkel
elkőteni	elkölteni
elkőtötte	elköltötte
elkőtötték	elköltötték
elkűdte	elküldte
elkűdték	elküldték
elkűttem	elküldtem
ellakhatol	ellakhatsz
ellapitotta	ellapította
ellazsnyakolta	ellazsnakolta
ellenfelive	ellenfelével
ellenfelivel	ellenfelével
ellenkeznyi	ellenkezni
ellenségöd	ellenséged
ellenségödet	ellenségedet
ellenségöm	ellenségem
ellensíg	ellenség
ellentállani	ellentállni
ellenállani	ellenállni
ellgetted	elégetted
elliszkol	eliszkol
ellopik	ellop
ellyenhez	ilyenhez
ellötte	ellőtte
ellőjáró	elöljáró
elmasérozik	elmasírozik
elmasérozott	elmasírozott
elmegyen	elmegy
elmenejen	elmenjen
elmenek	elmegyek
elmentenek	elmentek
elmenyek	elmegyek
elmenyen	elmegy
elmenyünk	elmegyünk
elmenék	elmentem
elmenünk	elmegyünk
elmodta	elmondta
elmondá	elmondta
elmonta	elmondta
elmulik	elmúlik
elmuljon	elmúljon
elmulnak	elmúlnak
elmult	elmúlt
elmátkásittsa	elmátkásítsa
elmén	elmegy
elméssz	elmész
elmëgyën	elment
elmënnyi	elmenni
elmëntem	elmentem
elmönt	elment
elmöntek	elmentek
elmönyön	elmegy
elmúlasztani	elmulasztani
elmúllott	elmúlt
elmúlyik	elmúlik
elne	élne
elnem	élnem
elnyujtotta	elnyújtotta
elnyúlott	elnyúlt
elnémúl	elnémul
elnéműlt	elnémult
elole	előle
elopi	ellopja
elorántotta	előrántotta
eloször	először
elott	előtt
elotte	előtte
elovassa	elolvassa
elporónánk	elporolnánk
elpusztitom	elpusztítom
elpusztol	elpusztul
elpusztulniok	elpusztulniuk
elpusztúl	elpusztul
elpörli	elperli
elrablád	elraboltad
elrejtőz	elrejtőzik
elrekedett	elrekedt
elrepüle	elrepül
elrepűl	elrepül
elsetétedtek	elsötétedtek
elso	első
elszaladott	elszaladt
elszaladtott	elszaladt
elszalatt	elszaladt
elszegeődök	elszegődök
elszorják	elszórják
elszunnyadott	elszunnyadt
elszégyenlette	elszégyellte
elszéledett	elszéledt
elször	először
elsöprötte	elsöpörte
elsülyedett	elsüllyedt
elsülyedt	elsüllyedt
eltakarittatták	eltakaríttatták
eltanálta	eltalálta
elteltivel	elteltével
eltemetkeztenek	eltemetkeztek
eltemetésit	eltemetését
eltikkadott	eltikkadt
eltisztittsátok	eltisztítsátok
eltunt	eltűnt
eltëvedt	eltévedt
eltívelyedett	eltévelyedett
eltökben	éltükben
eltöszi	elteszi
eltünik	eltűnik
eltünnek	eltűnnek
eltünt	eltűnt
eltőlë	eltörölte
eltőtötte	eltöltötte
elvedd	elvedd
elvergődhetel	elvergődhetsz
elveszlik	elveszik
elvinnyi	elvinni
elviszen	elvisz
elvittík	elvitték
elvivé	elvitte
elvonull	elvonul
elvonút	elvonult
elvágtaták	elvágtaték
elvákta	elvágta
elvëttem	elvettem
elvígezte	elvégezte
elvígeztík	elvégezték
elvíszi	elviszi
elvót	elvolt
elvörösödvel	elvörösödve
elvötte	elvette
elyen	ilyen
elyeneket	ilyeneket
elzűllik	elzüllik
eláljon	elálljon
elárúlják	elárulják
elébbvaló	előbbvaló
elébetek	elébe
elébújt	előbújt
elédbe	eléd
eléfogta	előfogta
elégedték	elégették
elégyött	előjött
elégödve	elégedve
eléhozatta	előhozatta
eléhozta	előhozta
eléhozták	előhozták
eléhozza	előhozza
eléhíjja	előhívja
eléhítta	előhívta
eléhívatta	előhívatta
eléhívják	előhívják
eléhívták	előhívták
eléjön	előjön
eléjött	előjött
eléjő	előjön
eléjű	előjön
elékapott	előkapott
elékeresi	előkeresi
elékerült	előkerült
elékerültek	előkerültek
elékiáltotta	előkiáltotta
eléláll	előáll
elémenyen	elémegy
elémondja	elmondja
elémondják	elmondják
elémutatta	előmutatta
elérakogatta	előrakogatta
elésompolyodik	elősompolyodik
elészedi	előszedi
elészedte	előszedte
elészól	előszól
elészólítják	előszólítják
eléugrik	előugrik
elévesz	elővesz
eléveszi	előveszi
eléveszik	előveszik
elévett	elővett
elévette	elővette
elévezettek	elővezettek
elévöszi	előveszi
elëbe	elébe
elíbb	előbb
elíg	elég
elígesse	elégesse
elígett	elégett
elígette	elégette
elígnek	elégnek
elír	elér
elíri	eléri
elírik	elérik
elírkezett	elérkezett
elírkeznek	elérkeznek
elírkeztek	elérkeztek
elírnek	elérnek
elírte	elérte
elírtek	elértek
elírtík	elérték
elódalgott	eloldalgott
elódalog	eloldalog
elódta	eloldotta
elódám	eloldottam
elöbbenit	előbbit
elölrül	elölről
elörehaladt	előrehaladt
elött	előtt
elötte	előtte
elötti	előtti
elü	elöl
elül	elöl
elül-hátul	elől-hátul
elütte	elütötte
előbbeni	előbbi
előbujjon	előbújjon
előbujtak	előbújtak
előgyütt	előjött
előhítta	előhívta
előjő	előjön
előljárójukat	elöljárójukat
előljárókat	elöljárókat
előlle	előle
előllem	előlem
előmbe	elém
előreküldötte	előreküldötte
előreszaladott	előreszaladt
elősször	először
előterömti	előteremti
előttek	előttük
előttik	előttük
előttök	előttük
elővövé	elővevé
előzetesn	előzetesen
előállani	előállni
elűl	elöl
emberbül	emberből
emberbő	emberből
emberekvel	emberekkel
emberesedjél	emberesedj
emberit	emberét
embertő	embertől
embertűl	embertől
embër	ember
embërnek	embernek
embör	ember
embörnek	embernek
embört	embert
emböröket	embereket
emböröknek	embereknek
emböröljön	embereljen
emeber	ember
emelegették	emlegették
emelekdése	emelkedése
emelkegyik	emelkedik
emelyik	amelyik
ement	elment
emerre	erre
emerről	erről
emez	ez
emezamaz	emez-amaz
emezt	ezt
emigyen	így
emilyen	ilyen
emisszió-kereskedelem	emissziókereskedelem
emissziókereskedelmi	emisszió-kereskedelmi
emitt	itt
emlikszëm	emlékszem
emlitette	említette
emliékiére	emlékére
emlékezetibe	emlékezetébe
emménk	miénk
emönt	elment
emöntünk	elmentünk
emúnak	elmúlnak
enbem	engem
energia-portfolió	energiaportfólió
energia-portfólió	energiaportfólió
engedelmeskedel	engedelmeskedsz
engedelmeskednyi	engedelmeskedni
engedjé	engedj
engedtík	engedték
engedtítek	engedtétek
engettek	engedtek
engém	engem
engëm	engem
engöggyem	engedjem
engötte	engedte
enneka	ennek
enniök	enniük
ennyi-innya	enni-inni
ennyivalójok	ennivalójuk
ennyivalót	ennivalót
enyim	enyém
enyimbe	enyémbe
enyimet	enyémet
enyím	enyém
enyímet	enyémet
eppen	éppen
eppenös	éppen
epéjje	epéje
epéjök	epéjük
eravis-ban	eravisban
erdejibe	erdejébe
erdeménye	eredménye
erdo	erdő
erdobol	erdőből
erdore	erdőre
erdoszélen	erdőszélen
erdélybü	erdélyből
erdélyis	erdélyi
erdörő	erdőről
erdőbül	erdőből
erdőbűl	erdőből
erdőrő	erdőről
erdőszílben	erdőszélben
erdőszílre	erdőszélre
eredett	eredt
eredmény-növekedés	eredménynövekedés
eredzkedett	ereszkedett
ereggy	eredj
ereggyé	eredj
erejek	erejük
erejit	erejét
erejtőzés	elrejtőzés
erejtőzött	elrejtőzött
erejöket	erejüket
eresszön	eresszen
ereszetbe	erezetbe
ereszkedjík	ereszkedjék
ereszkedött	ereszkedett
ereszködött	ereszkedett
eresztlek	eresztelek
ereőm	erőm
ereősködött	erősködött
eridj	eredj
eriggy	eredj
erire	erére
erisztünk	eresztünk
eros	erős
erosek	erősek
erosködött	erősködött
erre-arra	erre-arra
errő-arró	erről-arról
errűl	erről
erted	érted
erőködik	erőlködik
erőködött	erőlködött
erőltettík	erőltették
erősködöl	erősködsz
erőss	erős
erőssek	erősek
erőssen	erősen
erőst	erősen
esivalkodta	elsivalkodta
eskövőkor	esküvőkor
esküdnyi	esküdni
esküjök	esküjük
esküjöket	esküjüket
esküvének	esküsznek
esküvőröl	esküvőről
esküvőrő	esküvőről
esmerjék	ismerjék
esmé	ismét
esmént	ismét
esmérnek	ismernek
esmért	imsert
esmérte	ismerte
esmértem	ismertem
esmérték	ismerték
esmét	ismét
esseő	eső
esseőt	esőt
essze	össze
esszecsapja	összecsapja
esszecsapnak	összecsapnak
esszecsaptak	összecsaptak
esszekeresgélte	összekeresgélte
esszekötözték	összekötözték
esszekőtek	összekeltek
esszemorzsálták	összemorzsálták
esszeméregette	összeméregett
esszerogyott	összerogyott
esszeszedegetni	összeszedegetni
esszeszedi	összeszedi
esszevadászták	összevadászták
esszeverekedett	összeverekedett
esszeverekedtek	összeverekedtek
esszeütköztek	összeütköztek
esszeütök	összeütök
esső	eső
essőt	esőt
essőü	eső
estee	estée
estelig	estig
estennet	este
estve	este
estvéjén	estéjén
estvéli	esti
estyi	esti
estyig	estig
estéjin	estéjén
estélig	estig
esténkint	esténként
esténkínt	esténként
estëjën	estéjén
estíre	estére
estít	estét
eszegelődik	elszegődik
eszibe	eszébe
eszire	eszére
eszit	eszét
eszivel	eszével
eszre	észre
eszreveszen	észrevesz
eszrevette	észrevette
eszrevették	észrevették
esztekét	ösztökét
esztekével	ösztökével
esztend	esztendő
esztendeji	esztendei
esztendejig	esztendeig
esztendeő	esztendő
esztendeőbe	esztendőbe
esztendeős	esztendős
esztenába	eszténába
esztenához	eszténához
esztenáig	eszténáig
esztenára	eszténára
esztergyába	esztergába
eszterja	eszterga
eszteron	eszteren
eszëmbe	eszembe
eszëmën	eszemen
eszök	eszük
eszökre	eszükre
eszőnk	eszünk
esëtt	esett
esöt	esőt
esött	esett
esőjé	esőért
esőtőcsért	esőtölcsért
etetnyi	etetni
ett	evett
ett-itt	evett-ivott
ettenek	ettek
etteő	ettől
ettül	ettől
ettűl	ettől
etyszóval	egyszóval
etűnt	eltűnt
eu-bizottság	eu-bizottság
euro-piac	europiac
europexpert-ben	europexpertben
euró-menetrend	eurómenetrend
euró-övezet	euróövezet
euró0övezetben	euró-övezetben
euróárfolyam	euró-árfolyam
ev	év
evel	evvel
eveszett	elveszett
evittík	elvitték
evíst	evést
ezekbűl	ezekből
ezekrű	ezekről
ezekvel	ezekkel
ezenn	ezen
ezentül	ezentől
ezered	ezred
ezeret	ezret
ezermilliom	ezermillió
ezerszinü	ezerszínú
eztet	ezt
ezzel-azzal	ezzel
ezér	ezért
ezétt	ezért
ezër	ezért
ezír	ezért
ezök	ezek
ezön	ezen
ezútán	ezután
ezüsterdőbül	ezüsterdőből
ezüsthúszas	ezüsthuszas
ezüstkalán	ezüstkanál
ezüstpínz	ezüstpénz
ezüsttányírba	ezüsttányérba
ezüstössek	ezüstösek
ezűstszőrü	ezüstszőrű
eérsz	érsz
eételëm	ételem
eő	ő
eősiccsék	erősítsék
fa-rakáshoz	farakáshoz
faarúl	fáról
fabad	szabad
faggyugyertyácskákat	faggyúgyertyácskákat
faggyujából	faggyújából
fajja	fája
fakadott	fakadt
falatonkint	falatonként
faligyik	faligyík
falikigyót	falikígyót
falró	falról
falubanj	faluban
falubó	faluból
falubúl	faluból
falujok	falujuk
falujokba	falujukba
falujokban	falujukban
falujokot	falujukat
falukot	falukat
falurul	faluról
falurú	faluról
falutúl	falutól
faluuu	falu
faluvígen	faluvégen
falvakró	falvakról
falújig	faluig
familiám	famíliám
famívesek	faművesek
fanéművel	fanemű
farancia	francia
farkambó	farkamból
farkambúl	farkamból
farkunkot	farkunkat
farkábul	farkából
farkáho	farkához
faráhó	farához
fatartóbo	fatartóból
fatty	fattyú
fauduba	faodúba
favályuba	favályúba
fazekfedo	fazékfedő
fazik	fazék
fazikba	fazékba
fazikmadzagban	fazékmadzagban
fazík	fazék
fazíkbúl	fazékból
fazíkhoz	fazékhoz
faé	fáért
feI	fel
feIelték	felelték
feIesége	felesége
feIérkeztek	felérkeztek
fed-nek	fednek
fedelire	fedelére
fedelit	fedelét
feellebbeznek	fellebbeznek
fegyverit	fegyverét
feherlófia	fehérlófia
fehir	fehér
fehérfettek	fehéredtek
fehérkenyérvel	fehérkenyérrel
fehérországbó	fehérországból
fehír	fehér
fehíren	fehéren
fehírníp	fehérnép
fejdelemhez	fejedelemhez
fejenkint	fejenként
fejeős	fejős
fejibe	fejébe
fejibűl	fejéből
fejiket	fejüket
fejiktől	fejüktől
fejin	fején
fejinél	fejénél
fejir	fehér
fejire	fejére
fejirűl	fejéről
fejivel	fejével
fejjën	fején
fejszefoktul	fejszefoktól
fejszéhe	fejszéhez
fejszít	fejszét
fejszível	fejszével
fejér	fehér
fejérnép	fehérnép
fejérnépek	fehérnépek
fejérnépeket	fehérnépeket
fejérvári	fehérvári
fejérvárott	Fehérvárott
fejëre	fejére
fejín	fején
fejír	fehér
fejírbe	fehérbe
fejít	fejét
fejök	fejek
fejöket	fejüket
fejül	felül
fekete-tengör	fekete-tenger
fekete-tengörre	fekete-tengerre
feketiére	feketéjére
fekhelyirűl	fekhelyéről
fekhetz	fekhet
fektetetett	fektetett
fekteteti	fekteti
fektettík	fektették
feküd	feküdt
feküdjé	feküdj
feküdnyi	feküdni
feküdött	feküdt
feküggyetek	feküdjetek
feküggyön	feküdjön
feküsznek	fekszenek
feküvő	fekvő
felakasztlak	felakasztalak
felakaszttatlak	felakasztatlak
felakaszttatta	felakasztatta
felakasztyák	felakasztják
felcsufolt	felcsúfolt
felcsúti	felcsuti
feldül	feldől
feldűl	feldől
feldűlt	feldőlt
felejcse	felejtse
felejtenni	felejteni
felejtethetek	felejthetek
felejtközött	felejtkezett
felelsége	felesége
felelé	felelte
feleségestől	feleségestül
feleségi	felesége
feleségihe	feleségéhez
feleségihez	feleségéhez
feleségihöz	feleségéhez
feleségihő	feleségéhez
feleségiknek	feleségüknek
feleséginek	feleségének
feleségire	feleségére
feleségit	feleségét
feleségitő	feleségétől
feleségitől	feleségétől
feleségivel	feleségével
feleségiét	feleségéét
feleségítő	feleségétől
feleségöd	feleséged
feleségöddel	feleségeddel
feleségödet	feleségedet
feleségöm	feleségem
feleségömet	feleségemet
feleségömnek	feleségemnek
feleségöt	feleséget
feleségűl	feleségül
felesëget	feleséget
felesíg	feleség
felesíge	felesége
felesíged	feleség
felesígeddel	feleségeddel
felesígedet	feleség
felesígem	feleség
felesígemet	feleség
felesíggel	feleség
felesígihez	feleségéhez
felesíginek	feleségének
felesígit	feleségét
felesígivel	feleségével
felesígiét	feleség
felesígnek	feleségnek
felesígül	feleségül
felesígűl	feleségül
felforditják	felfordítják
felfúvódík	felfúvódik
felharagudt	felharagodott
felhíjja	felhívja
felhójagzik	felhólyagzik
felhójagzás	felhólyagzás
felhőbül	felhőből
felhőbűl	felhőből
felhőe	felhővel
felhőve	felhővel
feli	felé
felibe	felébe
felinek	felének
felire	felére
felirják	felírják
felirva	felírva
felirűl	feléről
felit	felét
felivel	felével
feljuttak	feljutottak
feljére	fejére
feljő	feljön
feljőne	feljönne
felkeresnyi	felkeresni
felkeresésire	felkeresésére
felkesz	felkelsz
felköltlek	felköltelek
felkötte	felkötötte
felkőt	felkelt
felkőtek	felkeltek
felkőtt	felkelt
felkőttek	felkeltek
fellegbül	fellegből
fellázadott	fellázadt
fellëngol	fellángol
felmegyen	felmegy
felmelegenni	felmelegedni
felmenek	felmegyek
felmenyen	felmegy
felmutatá	felmutatta
felnyitta	felnyitotta
felnyútotta	felnyújtotta
felnyőttetek	felnőttetek
felníz	felnéz
felol	felől
felrugja	felrúgja
felrándítá	felrándította
felrántá	felrántotta
felsirta	felsírta
felszaladott	felszaladt
felszedtík	felszedték
felszedé	felszedte
felszinen	felszínen
felszinre	felszínre
felszinén	felszínén
felszinére	felszínére
felszivja	felszívja
felszállott	felszállt
felszí	felszív
felszíja	felszívja
felszítt	felszívott
felszítta	felszívta
felszólítá	felszólította
felsíged	felséged
felsíges	felséges
feltarisnyálva	feltarisznyálva
felteni	félteni
feltámastalak	feltámasztalak
feltátalták	feltálalták
feltételit	feltételét
feltítel	feltétel
feltítellel	feltétellel
feltünő	feltűnő
felvetyi	felveszi
felébredett	felébredt
felébredésteket	felébredéseteket
felébresztetté	felébresztettél
felébresztlek	felébresztelek
felébrezz	felébressz
feléjök	feléjük
feléledett	feléledt
felésége	felesége
felë	felé/fele
felíbred	felébred
felíbredt	felébredt
felöltöz	felöltözik
felőlök	felőlük
felőtözködött	felöltözködött
felőtöztettík	felöltöztették
felőtözött	felöltözött
felűl	felül
fenekin	fenekén
fenekit	fekekét
fenekivel	fenekével
fennebb	feljebb
fenyofa	fenyőfa
fenyőfákot	fenyőfákat
fenérnépek	fehérnépek
feredjem	fürödjem
feredjen	fürödjön
feredni	fürödni
feredőket	fürdőket
feredőkádat	fürdőkádat
feredőkádba	fürdőkádba
feredőkádban	fürdőkádban
ferencesekhő	ferencesekhez
ferső	felső
feszik	fekszik
feszitötte	feszítette
feteke	fekete
fevetett	felvetett
fevásárolta	felvásárolta
fezékról	fazékról
feőgyi	földje
ffollyik	folyik
fia-csikaja	fia-csikója
fiadzék	fiadzon
fiamtúl	fiamtól
fiamval	fiammal
fiassak	fiasak
fiatalasszon	fiatalasszony
fiatalembör	fiatalember
fiatalembört	fiatalembert
fiatalokot	fiatalokat
ficzánkoltak	ficánkoltak
figyelmire	figyelmére
figyelmit	figyelmét
fijacskám	fiacskám
fijajim	fiaim
fijatal	fiatal
fijatalasszony	fiatalasszony
fijatalembernek	fiatalembernek
fijatalembör	fiatalember
fiju	fiú
fiját	fiát
fijú	fiú
fijút	fiút
filed	füled
filek	félek
filem	fülem
filik	fülük
filire	fülére
filit	fülét
filivel	fülével
fillentettem	füllentettem
fillents	füllents
fillentő	füllentő
filt	félt
filű	fülű
finyes	fényes
finyesség	fényesség
fiok	fiuk
fioknak	fiuknak
firdővizibe	fürdővízébe
firissen	friss
firjhezmeneteliben	férjhezmenetelében
fitető	fűtető
fiu	fiú
fiuból	fiúból
fiuhoz	fiúhoz
fiunak	fiúnak
fiura	fiúra
fiut	fiút
fiuval	fiúval
fiyelmébe	figyelmébe
fizessé	fizess
fizetnyi	fizetni
fizetségöm	fizetségem
fizetté	fizettél
fizetésit	fizetését
fizetëk	fizetek
fizetőnk	fizetünk
fiáho	fiához
fiél	fial
fiészekbe	fészekbe
fiú-név	fiúnév
fiúho	fiúhoz
fiútestvírek	fiútestvérek
flekkenyeket	flekkeneket
flu	falu
fnrdulhatott	fordulhatott
fogada	fogadta
fogattak	fogadtak
fogdjanak	fogadjanak
fogga	foggal
foggya	fogyja
foggyék	fogyjon
foghagyma	fokhagyma
foghagymát	fokhagymát
foghagymával	fokhagymával
foghagymáér	fokhagymáért
foghajmát	fokhagymát
fogik	foguk
fogukval	fogukkal
fogyasztóvédelmi-	fogyasztóvédelmi
fogáva	fogával
fogóznia	fogódznia
fogózva	fogódzva
fojlyóra	folyóra
fokhajmát	fokhagymát
fokta	fogta
follyik	folyik
foly	folyik
folytatá	fojtatta
folyóho	folyóhoz
folyóviz	folyóvíz
folé	fölé
foló	folyó
fonjá	fonj
fonnal	fonnál
fonnivalómot	fonnivalómat
fonnyi	fonni
fontá	fontál
fonyatos	fonatos
fonyi	fonni
forditanyi	fordítani
forditják	fordítják
forditsa	fordítsa
forditson	fordítson
fordittok	fordítok
forditva	fordítva
fordollyék	forduljon
fordull	fordul
fordétva	fordítva
fordëtva	fordítva
fordídd	fordítsd
fordúl	fordul
fordúlj	fordulj
fordúlnak	fordulnak
fordúlni	fordulni
fordúlva	fordulva
forgalom-növekedés	forgalomnövekedés
forgalomvisszaesésre	forgalom-visszaesésre
forganytyúját	forgantyúját
forgattya	forgatja
forgoóldol	forgolódsz
forgásibul	forgásából
forgó-szél	forgószél
forgószélhön	forgószélhez
forgószéltűl	forgószéltől
forin	forint
forint-befektetéseik	forintbefektetéseik
forint-erősítés	forinterősítés
forint-kamatok	forintkamatok
forintírt	forintért
forma-érzéke	formaérzéke
formáju	formájú
forra	forrt
forráshó	forráshoz
fotta	fogta
fottán	fogytán
fox-ot	foxot
fraknfurt	frankfurt
francioarszág	franciaország
frisseség	frissesség
frustokóni	frustukolni
frustukójjon	frustukoljon
fuj	fúj
fujja	fújja
ful	fúl
fulemule	fülemüle
fulë	füle
fundamentoma	fundamentuma
fur	fúr
furjon	fúrjon
futkároz	futkározik
futta	futotta
futtak	futottak
fuvása	fúvása
fuvót	fúvót
fzékba	fazékba
fábul	fából
fábó	fából
fábúl	fából
fáho	fához
fáhó	fához
fáinoson	fáinosan
fáintos	fáinos
fáintosan	fáinosan
fájol	fázol
fákot	fákat
fáradott	fáradt
fáradsága	fáradtsága
fáradságba	fáradtságba
fáradsággal	fáradtsággal
fáradságod	fáradtságod
fáradságodat	fáradtságodat
fáradságomba	fáradtságomba
fáradságtúl	fáradtságtól
fáradságába	fáradtságába
fáradságában	fáradtságában
fáradságát	fáradtságát
fáradságért	fáradtságért
fárló	fáról
fárul	fáról
fáró	fáról
fárú	fáról
fárúl	fáról
fátul	fától
fátúl	fától
fázook	fázom
fááááj	fáj
fáááááj	fáj
féjjenek	féljenek
féjjetek	féljetek
féjszi	fejsze
féjszit	fejszét
félbeszakitja	félbeszakítja
félbolonnak	félbolondnak
félcsípejű	félcsípőjű
félelemtül	félelemtől
félelmibe	félelmébe
félgyürüt	félgyűrűt
féliéket	féléket
féljön	féljen
félrehítta	félrehívta
félretaszí	félretaszít
félreódalgott	félreoldalgott
félreódalogtak	félreoldalogtak
fének	félnek
fénkövet	fenkő
fénkő	fenkő
fénkőt	fenkőt
fényesset	fényeset
fényességt	fényességet
fényességtül	fényességtől
fényeségnek	fényességnek
fényës	fényes
fényös	fényes
fényösség	fényesség
féreinti	félreinti
féreturták	félretúrták
férfiat	férfit
férhez	férjhez
férhöz	férjhez
férjhe	férjhez
férjhő	férjhez
férremenyen	félremegy
férrevaló	félrevaló
fész	félsz
fészekfiut	fészekfiú
fészkit	fészkét
fészkökbe	fészkekbe
fészét	fejszét
fésüt	fésűt
fésűlködik	fésülködik
fétek	féltek
fétünk	féltünk
fël	fel
fëlliteres	félliteres
fëlígérkezett	felígérkezik
fërfi	férfi
fílek	félek
fílj	félj
fílni	félni
fíltem	féltem
fílík	fűlik
fínom	finom
fínyesebb	fényesebb
fínyesebbnél	fényesebbnél
fínyessígtűl	fényességtől
fínyit	fényét
fírfi	férfi
fírnek	férnek
físzkelt	fészkelt
fódoztatta	foltoztatta
fólj	szólj
fórrald	forrald
fórrni	forrni
fórrott	forrt
fót	folt
fótosat	foltosat
föcskendezni	fecskendezni
födözni	fedezni
födözzön	fedezzen
födőre	fedőre
föhő	felhő
föjhő	felhő
föjhőbül	felhőből
föjül	fölül
föladat	feladat
föladatot	feladatok
fölalá	fölalá
fölalát	fölalá
fölcsöpörödött	felcseperedett
földbü	földből
földbűl	földből
földgáz-törvény	földgáztörvény
földiekvel	földiekkel
földik	földig
földjin	földjén
földjire	földjére
földmives	földműves
földmivesek	földművesek
földrűl	földről
földtűl	földtől
fölebb	följebb
fölemeni	felemelni
fölet	földet
fölfödözni	fölfedezni
fölháborodék	fölháborodott
fölhő	felhő
fölhőbe	felhőbe
fölhőbül	felhőből
fölhők	felhők
fölhőkbül	felhőkből
fölhőket	felhőket
fölhőn	felhőn
fölhőt	felhőt
fölibük	föléjük
följebb-följebb	följebb-följebb
fölkellett	kellett
fölkerekediek	fölkerekedik
fölkerekedének	fölkerekedtek
fölkereködött	fölkerekedett
fölkászmálódani	fölkászálódni
fölkászmálódni	fölkászálódni
fölkászmálódtak	fölkászálódtak
fölkőt	fölkelt
fölleg	felleg
föllegen	fellegen
fölleget	felleget
fölmégy	fölmész
fölrugja	fölrúgja
fölseje	fölső
fölszaladott	fölszaladt
fölszinre	felszínre
fölszivja	fölszívja
fölszállanak	fölszállnak
fölszállott	fölszállt
fölszömtelenködött	felszemtelenedett
fölsántyikált	fölsántikált
fölségöd	felséged
fölségös	felséges
fölségős	felséges
fölsőtiszai	felső-tiszai
fölturkásszák	föltúrják
föltámaszsza	föltámasztja
föltételéhöz	feltételéhez
föltött	feltett
fölvettették	fölvetették
fölvilágositással	felvilágosítás
fölébrennek	felébrednek
fölébrett	felébredt
fölébrösztél	felébresztettél
fölémbe	fölébe
fölíbred	fölébred
fölíbredt	fölébredt
fölöltöztetett-	fölöltöztetett
fölöttes	felettes
fölötteseit	feletteseit
fölőtözik	felöltözik
fölőtözött	fölöltözött
fön	fönn
fönek	főnek
fönfeledte	fönnfeledte
fönnszóval	fennszóval
förtelemes	förtelmes
förödjél	fürödj
förödve	fürödve
fössék	fessék
fösvíny	fösvény
fösvínykedj	fösvénykedj
fú	fúj
fúj	fúj
fúk	fiúk
fúnni	fújni
fúrdult	fordult
fúrikba	furikba
fúrúja	fúrója
fútnak	futnak
fútt	fújt
fúvintsd	fuvintsd
fülbevalókot	fülbevalókat
fülemile	fülemüle
fülhúzgolta	fölhúzogatta
fülibe	fülébe
fülihez	füléhez
fülik	fülük
fülikből	fülükből
fülin	fülén
fülinél	fülénél
fülire	fülére
füliről-farkáról	füléről-farkáról
fülit	fülét
fülitől	fülétől
fülsértőén	fülsértően
fülugrott	fölugrott
fürdöl	fürdesz
füre	fűre
fürész	fűrész
fürüdőbe	fürdőbe
fürüdőben	fürdőben
fürüdőből	fürdőből
fürüszteti	füröszteti
fürüsztésekben	fürösztésekben
fürüsztött	fürösztött
fürüsztötte	fürösztötte
fürüsztütte	fürösztötte
füstbő	füstből
füstgomalyagbló	füstgomolyagból
füstolik	füstölik
füstt	füst
füstököt	füstöket
füstőlt	füstölt
füszál	fűszál
füsülködött	fésülködött
füteni	fűteni
fütyögette	füttyögette
fütyögtek	füttyögtek
fütyürészni	fütyörészni
fütyüt	fütyült
fütyűl	fütyül
fütyűlni	fütyülni
füvel	fűvel
füz	fűz
füőznek	főznek
főd	föld
fődbe	földbe
fődben	földben
fődben-	földben
fődbű	földből
fődde	földdel
fődek	földek
fődet	földet
fődhö	földhöz
fődhöragadt	földhözragadt
fődhöz	földhöz
fődi	földi
fődig	földig
fődje	földje
fődjeik	földjeik
fődre	földre
fődrű	földről
fődön	földön
fődünk	földről
főggye	földje
főggyire	földjére
főggyit	földjét
főgyütt	följött
főhajtotta	fölhajtotta
főhúzta	fölhúzta
főhő	felhő
főhő-szélbe	felhő-szél
főhőbe	felhőbe
főhőt	felhőt
főkapta	fölkapta
főkelök	felkelek
főkészítötte	felkészítette
főldet	földet
főldünk	földünk
főlve	főve
főnek-fának	fűnek-fának
főnyitotta	fölnyitotta
főosztályánk	főosztályának
főségös	felséges
fősülködik	fésülködik
fősüvel	fésűvel
főső	felső
főtátos	főtáltos
főtátosnak	főtáltos
főtátost	főtáltos
főur	főúr
főutazott	fölutazott
fővette	felvette
fővezírt	fővezért
főznyi	főzni
főztík	főzték
főzzé	főzz
főzzë	főzz
főzéshő	főzéshez
főügyészég	főügyészség
fűljon	főjön
fűréssze	fűrésze
fűrészvel	fűrésszel
fűsüljenek	fésüljenek
fűsüllődött	fésülődött
fűvecskét	füvecskét
fűvet	füvet
gabonapic	gabonapiac
gabonaszekcióban276	gabonaszekcióban
gajba	gallyba
gajj	gally
galamb-leány	galambleány
gallyakot	gallyakat
galy	gally
galyakból	gallyakból
ganajturo	ganajtúró
ganghon	ganghoz
gannajjábó	ganajából
garabanciás	garabonciás
garabociás	garabonciás
garabonci	garabonciás
garabonciják	garabonciák
garaboncijás	garabonciás
garaboncijások	garabonciások
garaboncijást	garabonciást
garaboncázs	garaboncás
garajcárt	krajcár
garboncziás	garabonciás
garboncás	garabonciás
garázskapu-	garázskapu
gata-árus	gataárus
gata-árusnak	gataárusnak
gata-árussal	gataárussal
gata-árust	gataárust
gatyakötőjjibű	gatyakötőjéből
gatyáér	gatyáért
gazda-asszony	gazdaasszony
gazdasszonyátul	gazdasszonyától
gazdasásgban	gazdaságban
gazdsasági	gazdasági
gazdájokhoz	gazdájukhoz
gazdájátúl	gazdájától
gazdáná	gazdánál
gazdátú	gazdától
gazzdád	gazdád
gedáim	gidáim
gedák	gidák
gedáknak	gidáknak
gedákot	gidákat
gedók	gidák
gelegonya	galagonya
genyes	gennyes
germanwings-szel	germanwingsszel
gidakülykök	gidakölykök
gidó	gida
gidócskáim	gidácskáim
gidócskáknak	gidácskának
gidóhúst	gidahúst
gidók	gidák
giosen	gioseni
glaxo-t	glaxót
gombgyát	gombját
gomboccá	gombóccá
gombolítok	gombolyítok
gombócokbúl	gombócokból
gond-tündér	gondtündér
gondndolkodott	gondolkodott
gondokval	gondokkal
gondolatja	gondolata
gondolatjára	gondolatára
gondolatját	gondolatát
gondotam	gondoltam
gondulta	gondolta
gondókozik	gondolkozik
gondót	gondolt
gondótam	gondoltam
gondúkodott	gondolkodott
gondút	gondolt
gonoszságikot	gonsoszságukat
gonoszságátó	gonoszságától
goroboncás	garabonciás
grimm	Grimm
gryere	gyere
guggojjon	guggoljon
gunarak	gúnárok
gunnyó	kunyhó
gunnyóból	kunyhóból
gunyáját	gúnyáját
gunárkacsa	gúnárkacsa
gunárnak	gúnárnak
guritják	gurítják
guzsallal	guzsallyal
guzsalyat	guzsalyt
guzsalyostól	guzsalyostul
gvárgyián	gvárdián
gyalogszerrel	gyalog
gyanu	gyanú
gyanus	gyanús
gyanusitott	gyanúsított
gyanut	gyanút
gyarapszól	gyarapszol
gyargaltak	nyargaltak
gyavittani	javítani
gyeplűt	gyeplőt
gyeplűvel	gyeplővel
gyepühöz	gyepűhöz
gyepüre	gyepűre
gyerekbő	gyerekből
gyerekik	gyerekek
gyerekinek	gyerekének
gyerekit	gyerekét
gyerekivel	gyerekével
gyerekjány	gyereklány
gyereksirást	gyereksírást
gyereőnk	gyerünk
gyergyát	gyertyát
gyermeksirás	gyermeksírás
gyermekët	gyermeket
gyermekök	gyermekek
gyermekökkel	gyermekekkel
gyermëknek	gyermeknek
gyermëkët	gyermeket
gyertyákot	gyertyákat
gyeryája	gyertyája
gyerëk	gyerek
gyerëkis	gyerekes
gyerëkët	gyereket
gyerö	gyerek
gyerök	gyerek
gyeröke	gyereke
gyerökkoromba	gyerekkoromba
gyerökre	gyerekre
gyerökök	gyerekek
gyerököt	gyereket
gyerőnk	gyerünk
gyikokról	gyíkokról
gyikot	gyíkot
gyiksárkányra	gyíksárkányra
gyilkolniok	gyilkolniuk
gyilkosrétnek	gyilkos-rétnek
gyiák	diák
gyiáknak	diáknak
gyogyítsátok	gyógyítsátok
gyolcsbúl	gyolcsból
gyomrábo	gyomrából
gyovonjál	gyónjál
gyovonni	gyónni
gyovontam	gyóntam
gyovónni	gyónni
gyugdostam	dugdostam
gyugja	dugja
gyugjátok	dugjátok
gyujtanak	gyújtanak
gyujtani	gyújtani
gyujtott	gyújtott
gyujtottak	gyújtottak
gyujts	gyújts
gyujtsák	gyújtsák
gyukja	dugja
gyuljon	gyúljon
gyurnak	gyúrnak
gyërtyaszentülőkor	gyertyaszentelőkor
gyógy-idegenforgalmi	gyógyidegenforgalmi
gyógyfűveket	gyógyfüveket
gyógyithat	gyógyíthat
gyógyittya	gyógyítja
gyógyittó	gyógyító
gyógyétani	gyógyítani
gyógyétotta	gyógyította
gyógyíttyák	gyógyítják
gyógyúl	gyógyul
gyöhetett	jöhetett
gyöhetnek	jöhetnek
gyöjjenek	jöjjenek
gyöjjön	jöjjön
gyöjjönek	jöjjenek
gyön	jön
gyönne	jönne
gyönni	jönni
gyönnyi	jönni
gyönyören	gyönyörűen
gyönyörséges	gyönyörűséges
gyönyöru	gyönyörű
gyönyöruséges	gyönyörűséges
gyönyörübb	gyönyörűbb
gyönyörüséged	gyönyörűséged
gyönyörűsígtűl	gyönyörűségtől
gyönöyr	gyönyör
gyöplűt	gyeplőt
gyöppöt	gyöpöt
gyössz	jössz
gyött	jött
gyött-ment	jöttment
gyöttek	jöttek
gyöttetek	jöttetek
gyötté	jöttél
gyöttök	jöttök
gyövünk	jövünk
gyövő	jövő
gyújtnak	gyújtanak
gyújták	gyújtották
gyúllást	gyúlást
gyúrjék	gyúrjon
gyútottak	gyújtottak
gyútósfával	gyújtósfával
gyühet	jöhet
gyüjjenek	jöjjenek
gyüjjön	jöjjön
gyüjtött	gyűjtött
gyümölcsit	gyümölcsét
gyümőcs	gyümölcs
gyümőcsfával	gyümölcsfával
gyümőcsöt	gyümölcsöt
gyün	jön
gyünnek	jönnek
gyünni	jönni
gyürü	gyűrű
gyürüről	gyűrűről
gyürüt	gyűrűt
gyüssz	jössz
gyüsz	jössz
gyütt	jött
gyüttek	jöttek
gyüttem	jöttem
gyütté	jöttél
gyüttél	jöttél
gyüvök	jövök
gyüvünk	jövünk
gyűrü	gyűrű
gyűrüjét	gyűrűjét
gyűrüt	gyűrűt
gyűrűji	gyűrűi
gyűrűjöket	gyűrűjüket
gyűrűköt	gyűrűket
gyűtött	gyűjtött
gyűtötte	gyűjtötte
gárgyája	gárgya
gátho	gáthoz
gépiőar	gépipar
gépjármű-szakértés	gépjárműszakértés
gënge	gyenge
gödröknak	gödröknek
gödörbűl	gödörből
gömbec	gömböc
gömbeccel	gömböccel
gömbecet	gömböcöt
gömbechez	gömböchöz
gömböstűket	gombostűket
gömböstűt	gombostűt
gömböstűvel	gombostűvel
gúbacsot	gubacsot
gúnyolódtá	gúnyolódtál
gúnyájok	gúnyájuk
gúnárnaok	gúnárnak
gút	guta
gútot	gutát
güdröt	gödröt
güdörbe	gödörbe
hableany	hableány
hacsaka	hacsak
hacsikazug	hacsikazugi
hacsikazugi	Hacsikazugi
hacsukazugi	hacsikazugi
had	hadd
haggya	hagyja
haggyanak	hagyjanak
hagyatt-homlok	hanyatt-homlok
hagyjá	hagyjál
hagymáér	hagymáért
hagyniok	hagyniuk
hagynyi	hagyni
hagyítod	hajítod
hagyította	hajította
hajadonfűn	hajadonfővel
hajamot	hajamat
hajaszálai	hajszálai
hajdu	hajdú
hajingálta	hajigálta
hajitsa	hajítsa
hajitással	hajítással
hajja	hallja
hajjátok	halljátok
hajjëk	hallja
hajnuó	hajnal
hajom	hagyom
hajszált	hajszálat
hajtál	hajtottál
haju	hajú
hajulna	hajolna
hajult	hajolt
hajá	haja
hajábul	hajából
hajábó	hajából
hajítanni	hajítani
hajó-árbocokon	hajóárbocokon
halaványodik	halványodik
hallaniok	hallaniuk
hallassz	hallasz
hallnak	hallnak
hallottá	hallottál
hallottáttok	hallottátok
hallsz	hallasz
halltam	hallottam
halnyi	halni
halottakval	halottakkal
halottaséneket	halottasének
halotthalaványan	halotthalványan
halva-árus	halvaárus
halva-árusokat	halvaárusokat
halva-árussal	halvaárussal
halálgyümölcsbő	halálgyümölcsből
halálónkot	halálunkat
halászatbó	halászatból
halászgatnyi	halászgatni
halászoktúl	halászoktól
hama	hamar
hamma	hamar
hammas	hamvas
hammasfazékból	hamvasfazékból
hanaltájban	hajnaltájban
hangya-ember	hangyaember
hanover	hannover
hanoverben	hannoverben
hanyat	hanyatt
hanyattég	hanyatt
hanyba	hányba
hanyban	hányban
hanyigáljak	hajigáljak
hanyigálsz	hajigálsz
hanyután	hanyatt
hanyítani	hajítani
hanëm	hanem
hanëmha	hanem
haomannap	harmadnap
haraghatik	haragudhat
haragudjá	haragudj
haragudnyi	haragudni
haragudt	haragudott
haragusznak	haragszanak
harangjaér	harangjáért
harangjúk	harangjuk
harangomot	harangomat
harangosztak	harangoztak
harangoznyi	harangozni
harangozóér	harangozóért
harmaccor	harmadszor
harmaccora	harmadszorra
harmad-kakasszókor	harmadkakasszókor
harmadját	harmadát
harmadrészit	harmadrészét
harmadszorra	harmadszor
harmagyik	harmadik
harmagyiknak	harmadiknak
harmagyikot	harmadikat
harmannap	harmadnap
harmdiknál	harmadiknál
harmincnyóc	harmincnyolc
has-árus	hasárus
has-árusnak	hasárusnak
has-árusra	hasárusra
has-árust	hasárust
hasadékját	hasadékát
hasgatta	hasogatta
hasigálta	hasogatta
hasitani	hasítani
hasonlitt	hasonlít
hasonlóképen	hasonlóképpen
hasonól	hasonló
használató	használatú
használnyi	használni
használt-é	használt
haszony	haszon
hatalmok	hatalmuk
hatfelé	hatféle
hatta	hagyta
hattad	hagytad
hattam	hagytam
hatták	hagyták
hatvidres	hatvödrös
hatábó	határból
határbó	határból
határjába	határába
határmesgyéjén	határmezsgyéjén
havassát	havasát
hazabocsájtotta	hazabocsátotta
hazabolondolnyi	hazabolondolni
hazagyöjjünk	hazajöjjünk
hazagyön	hazajön
hazagyönni	hazajönni
hazagyött	hazajött
hazagyün	hazajön
hazagyünni	hazajönni
hazagyütt	hazajött
hazagyüttünk	hazajöttünk
hazahíja	hazahívja
hazajövél	hazajöttél
hazajő	hazajön
hazajőjj	hazajöjj
hazajőnek	hazajönnek
hazajű	hazajön
hazaláogatott	hazalátogatott
hazamegyen	hazamegy
hazamenek	hazamegyek
hazamennyi	hazamenni
hazamenyi	hazamenni
hazamönt	hazament
hazatelepődött	hazatelepedett
hazavihetöd	hazaviheted
hazavittík	hazavitték
hazavágyol	hazavágysz
hazaélve	hazaérve
hazaírkezik	hazaérkezik
hazaírkeztek	hazaérkeztek
hazaírnek	hazaérnek
hazaírt	hazaért
hazaírtek	hazaértek
hazud	hazudik
hazudtá	hazudtál
hazulrúl	hazulról
hazunni	hazudni
hazunnét	otthonról
hazájokat	hazájukat
hazámot	házamat
hazért	hazaért
hazúlról	hazulról
haódvilág	holdvilág
hederintett	hederített
hederitett	hederített
hegybűl	hegyből
hegyenvölgyön	hegyen-völgyön
hegyess	hegyes
hegyibe	hegyébe
hegyire	hegyére
hegyit	hegyét
hegyivel	hegyével
heje-huja	hejehuja
hejre	helyre
helettem	helyettem
helit	helyét
hellen	helyen
hellött	helyett
helybehagyták	helybenhagyták
helyheztette	helyeztette
helyheztettem	helyeztettem
helyibül	helyéből
helyikre	helyükre
helyikről	helyükről
helyin	helyén
helyire	helyére
helyit	helyét
helyrűl	helyről
helytt	helyett
helyéböl	helyéből
helyën	helyen
helyët	helyet
helyökre	helyükre
helön	helyen
henem	hanem
hengergődz	hengergőzz
herceglegínnyel	herceglegénnyel
herceglegíny	herceglegény
herczegkisaszonnyal	hercegkisaszonnyal
herré	helyre
heréléstül	heréléstől
heródeshó	heródeshoz
hetegyik	hetedik
hetfő	hétfő
hetfőn	hétfőn
hetüs	hetes
hezza	hozza
hezzadörgölgetém	hozzádörgölgetém
hezzalő	hozzálő
hezzaszóllottam	hozzászóltam
hezzik	hozzájuk
hezzá	hozzá
hezzám	hozzám
heába	hiába
heétet	hetet
hibádzék	hibádzik
hid	híd
hidegleleésreő	hideglelésről
hidegleleősnek	hideglelősnek
hidon	hídon
hig	híg
higitják	higítják
higyje	higgye
higyjen	higgyen
higyjétek	higgyétek
hijj	hívj
hijjok	hívjuk
hijjom	hívom
hijjába	hiába
hijába	hiába
him	hím
himes	hímes
himet	hímet
himvarró	hímvarró
himzett	hímzett
himzőtűvel	hímzőtűvel
hinak	hívnak
hinarasból	hínárosból
hintennyi	hinteni
hintenyi	hinteni
hinár	hínár
hir	hír
hires	híres
hirt	hírt
hirtelenében	hirtelenjében
hirét	hírét
hirök	hírek
hirük-hamvuk	hírük-hamvuk
hiszén	hiszen
hitelestése	hitelesítése
hitelesítés-szolgáltatás	hitelesítésszolgáltatás
hitták	hívták
hittík	hitték
hiték	hitték
hiubúl	hiuból
hivassa	hívassa
hivassak	hívassak
hivatja	hívatja
hivatják	hívatják
hivatta	hívatta
hivek	hívek
hiven	híven
hivj	hívj
hivja	hívja
hivják	hívják
hivnak	hívnak
hivni	hívni
hivott	hívott
hivták	hívták
hiván	híván
hivó	hívó
hizelgő	hízelgő
hizelögni	hízelegni
hizik	hízik
hizni	hízni
hizó	hízó
hizóba	hízóba
hoember	hóember
hogy-hogy	hogyhogy
hogye	hogyan
hogyen	hogyan
hokiralyno	hókirálynő
hold-hegyek	holdhegyek
holdujság	holdújság/újhold
holtest	holttest
honapján	honlapján
honn	otthon
honnat	honnan
honnjába	honjába
hont-csitárbúl	hon-csitárból
hoppmester	hopmester
hordóbul	hordóból
hordóbúl	hordóból
hordókot	hordókat
horgyák	hordják
hosszi	hosszú
hoszták	hozták
hovat	havat
hová-merre	hová
hozi	hoz
hoznyi	hozni
hozzájok	hozzájuk
hozzáka	hozzák
hozzákezdték	hozzákezdtek
hozzákötte	hozzákötötte
hozzátíve	hozzátéve
hrét	hírét
hu-hu	huhú
huga	húga
hugai	húgai
hugátó	húgától
hul	hol
hun	hol
huncfut	huncut
huncfutsággal	huncutsággal
huncutságbúl	huncutságból
hunczut	huncut
hunmiját	holmiját
hunn	hol
hunnan	honnan
hunnet	honnan
hunnét	honnét
hunyadi	Hunyafi
hunyadnak	Hunyadnak
hupp	hopp
hurcolkoggyatok	hurcolkodjatok
hurka-bőrbe	hurkabőrbe
husevő	húsevő
hushagyó	húshagyó
hushagyókor	húshagyókor
husonhétser	huszonhétszer
hussát	húsát
hust	húst
husvét	húsvét
husvéti	húsvéti
husvétnak	húsvétnak
husvétra	húsvétra
huszonnígy	huszonnégy
huszonnígyet	hunszonnégyet
husát	húsát
husëvő	húsevő
huva	hova
huvá	hova
huzatom	húzatom
huzatta	húzatta
huzd	húzd
huzogatni	húzogatni
huzta	húzta
huzza	húzza
huzzák	húzzák
huzának	húztak
há	hát
háborúskodnyi	háborúskodni
hágy	hagy
háha	hátha
hálá	hála
hálákodni	hálálkodni
hálákodott	hálálkodott
hálákot	hálákat
hánni	hányni
hánta	hányta
hányi	hányja
háom	három
hármashegyen	Hármashegyen
hármokra	hármukra
hármotok	hármótok
három-nígy	három-négy
háromat	hármat
háromfele	háromfelé
háromnégy	három-négy
hárúl	hárul
hászen	hiszen
hátamrúl	hátamról
hátatforditanak	fordítanak
hátra-e	hátra
hátraszaladott	hátraszaladt
hátraszentölt	hátraszentelt
hátraszentölte	hátraszentelte
hátrujja	hátulja
hátrább-hátrább	hátrébb
hátrújja	hátulja
hátuljokat	hátuljukat
hátyijába	hátuljába
hátárló	hátáról
hátáro	hátáról
hátáron	határon
hátárúl	hátáról
házakot	házakat
házamtó	házamtól
házasodhatik	házasodhat
házasodjá	házasodjál
házasodnyi	házasodni
házasodol	házasodsz
házasúlandó	házasulandó
házbaó	házból
házbul	házból
házbó	házból
házbú	házból
házbúl	házból
házetőre	háztetőre
házfőggyën	földjén
házho	házhoz
házhó	házhoz
házikóho	házikóhoz
házná	háznál
házo	ház
házok	házak
házokba	házakba
házruó	házról
házrú	házról
házrúl	házról
háztatőket	háztetőket
háztetejin	háztetején
háztetejire	háztetőre
háztetejën	háztetőn
házteteön	háztetőn
háztetún	háztetőn
háztul	háztól
háztuó	háztól
háztúl	háztól
házáná	házánál
házátul	házától
házátó	házától
házónk	házunk
házónkot	házunkat
hááát	hát
héjjba	héjba
héjjánosság	hiányosság
héjjánossága	hiányossága
héjjával	híja
hét-nyóc	hét-nyolc
hétfejit	hétfejűt
hétszerte	hétszer
hétyig	hétig
hétën	héten
hëgyës	hegyes
hëtfün	hétfőn
hí	hív
hídast	hidast
hídd	hívd
híjja	hívja
híjjam	hívjam
híjjatok	hívjatok
híjjuba	hijuba
híjják	hívják
híjába	hiába
híjúba	hijuba
hínak	hívnak
híni	hívni
hínni	hívni
hínya	hívnia
hírbűl	hírből
híri	híre
hírik-porik	hírük-poruk
hírit	hírét
hírivel	hírével
hírök	hírek
hít	hívott
hítt	hívott
hítta	hívta
híttak	hívtak
híttuk	hívtuk
híttunk	hívtunk
hítták	hívták
híttál	hívtál
híták	hívták
hízlalom	hizlalom
hízlaló	hizlaló
híába	hiába
hó-rukk	hórukk
hódit	hódít
hódtőttekor	holdtöltekor
hódvilágba	holdvilágba
hódvilágnak	holdvilág
hóhír	hóhér
hól	hal
hólt	halt
hólyagas	hólyagos
hónajmankón	hónaljmankón
hónap	holnap
hópehely-virágok	hópehelyvirágok
hót	halt
hótak	haltak
hótaktól	holtaktól
hótt	holt
hótta	holta
hóttak	haltak
hóttakról	holtakról
hóttukig	holtukig
hótunk	haltunk
hö	hő
högye	hegye
högyös	hegyes
högyösen	hegyesen
högyöset	hegyeset
höj	hej
húgám	húgom
húhagyuó	húshagyó
húll	hull
húlljatok	hulljatok
húllnak	hullanak
húnn	hol
húnyta	hunyta
húsbó	húsból
hússzorta	hússzor
húsviét	húsvét
húzaódozik	húzódozik
húznyi	húzni
húzzsanak	húzzanak
húzzsatok	húzzatok
húzzá	húzzál
hüljön	hűljön
hütelbe	hitelbe
hütömre	hitemre
hüvelybűl	hüvelyből
hüvelykuját	hüvelykujját
hő	hő
hőj	hej
hűségës	hűséges
hűsíges	hűséges
hűveg	hüvelyk
hűvelyk	hüvelyk
iccaka	éjszaka
icczakának	éjszakának
idasapámánál	édesapámnál
idegeny	idegen
idegyött	idejött
idehallgassonak	idehallgassanak
idehurcukodtunk	idehurcolkodtunk
ideji	ideje
idejibe	idejébe
idejig	ideig
idejik	idejük
idejin	idején
idejit	idejét
idejébül	idejéből
idejök	idejük
idejövél	idejöttél
idejő	idejön
idejővé	idejöttél
idekültél	ideküldtél
ides	édes
idesanyja	édesanyja
idesanyád	édesanyád
idesanyám	édesanyám
idesanyámnak	édesanyámnak
idesapja	édesapja
idesapám	édesapám
ideslánya	édeslánya
idességiből	édességéből|édességeiből
ideáig	idáig
ideírkezik	ideérkezik
időjárási-	időjárási
időjárásrú	időjárásról
idősseket	időseket
időér	időért
idű	idő
ie'mennek	elmennek
iffju	ifjú
ifiak	ifjak
ifiember	ifiember
ifiú	ifjú
ifju	ifjú
ifjuhoz	ifjúhoz
ifjúsággyümőcs	ifjúsággyümölcs
ifjúsággyümőcsbe	ifjúsággyümölcsbe
iféli	éjféli
igazitotta	igazította
igazittani	igazítani
igazittását	igazítását
igazok	igazuk
igazságbó	igazságból
igazétotta	igazította
igenyöst	egyenesen
igirte	ígérte
igirtík	ígérték
igy	így
igyenessen	ingyenesen
igyenösen	egyenesen
igyenössen	egyenesen
igyík	igyon
igázsá	igaza
igér	ígér
igéretet	ígéretet
igéretünket	ígéretünket
igérjen	ígérjen
igérközék	ígérkezik
igért	ígért
igérte	ígérte
igértem	ígértem
igír	ígér
igírjík	ígérjék
igírni	ígérni
igön	igen
ihatik	ihat
ihes	éhes
iiigyunk	igyunk
ijdetemben	ijedtemben
ijedett	ijedt
ijedtibe	ijedtében
ijedtiben	ijedtében
ijen	ilyen
ijenkor	ilyenkor
ijesztegették	ijesztgették
ijettibe	ijedtében
ijje	éjjel
ijjedtem	ijedtem
ijjedtébcn	ijedtében
ijjel	éjjel
ijjelin	éjjelén
ijjesszen	ijesszen
ijjeszteni	ijeszteni
ijjesztik	ijesztik
ijjesztő	ijesztő
ijjett	ilyet
iletem	életem
ill	ily
illat-üzletből	illatüzlet
illen	ilyen
illendoen	illendően
illesmihez	ilyesmihez
illy	ily
illyen	ilyen
illyet	ilyet
ilonaé	ilonáért
ilonáho	ilonához
ilonáró	ilonáról
ilyenbül	ilyenből
ilyenkó	ilyenkor
ilyenök	ilyenek
ilyesfélével	ilyesféle
im	ím
imakönyet	imakönyvet
ime	íme
imitt-amott	amott
immán	immár
imáccság	imádság
imáccságot	imádságot
imátkosztunk	imádkoztunk
imátkoznak	imádkoznak
imátkoznyi	imádkozni
imátkozott	imádkozott
inasomrúl	inasomról
inasrúl	inasról
inassa	inasa
inassárúl	inasáról
inassával	inasával
inci-finci	incifinci
indolt	indult
indulja	induljon
indull	indul
indzsellër	inzsellér
indúlnak	indulnak
indúlni	indulni
indúlt	indult
indút	indult
indútam	indultam
indútá	indultál
inek	inak
infláció-gerjesztő	inflációgerjesztő
ingöm	ingem
ingömet	engem
ingömöt	engem
innapot	ünnepet
innekső	innenső
innen-onnan	onnan
innenen	innen
innent	innen
innep	ünnep
innepbe	ünnepbe
innepeltek	ünnepeltek
innestől	innentől
innet	innét
innya	inni
innyi	inni
innén	innen
instállom	instálom
intelemrő	intelemről
internet-kapcsolat	internetkapcsolat
internetto	Internetto
internettó	internetto
iovacskáját	lovacskáját
ippeg	éppen
ippen	éppen
ippenn	éppen
ir	ír
irdas	ordas
irigysíg	irigység
irja	írja
irjunk	írjunk
irják	írják
irka-firka	irkafirka
irnak	írnak
irni	írni
irt	írt
irte	érte
irtózatossan	irtózatosan
irva	írva
iránybul	irányból
irányítik	irényítják
irígységet	irigységet
irígységtől	irigységtől
irótoll	írótoll
iskolábó	iskolából
ismerjík	ismerjék
ismeröm	ismerem
istallóba	istállóba
istenigazába	istenigazában
isteninek	istenének
istentehenkéjét	istentehénkéjét
istentül	istentől
istentű	istentől
istentűl	istentől
istenöm	istenem
istenös	istenes
istvánnétul	istvánnétól
istállóbó	istállóból
istáló	istálló
istálóba	istállóba
istálóban	istállóból
iszafahan	iszfahán
iszen	hiszen
iszfahan	iszfahán
iszkábázta	eszkábálta
itassá	itass
itatóvájú	itatóvályú
itellelt	itallal
itt-ett	ivott-evett
itthol	itthon
itthonrúl	itthonról
itthun	itthon
itéletet	ítéletet
iva	írva
ivogáltak	iddogáltak
ivszi	viszi
ivutt	ivott
izenem	üzenem
izenetemet	üzenetemet
izenetet	üzenetet
izenetre	üzenetre
izenetét	üzenetét
izeni	üzeni
izent	üzent
izentek	üzentek
izott	hízott
izzitani	izzítani
izéjive	izéjével
izéni	izélni
izétü	izétől
izéve	izével
iába	lába
iám	lám
iát	lát
iéféli	éjféli
iégen	jégen
iéger	jéger
iéjje	éjjel
iéjjel	éjjel
iéjjé	éjjel
iénekelnek	énekelnek
iénekelve	énekelve
iérviényes	érvényes
iévben	évben
j'az	az
jajgatásho	jajgatáshoz
jajjgatott	jajgatott
javaslahoz	javaslathoz
javitgatni	javítgatni
jaz	az
jaó	jó
jaóra	jóra
jaószág	jószág
jaószágot	jószágot
jedtibe	ijedtében
jegyessit	jegyesét
jegygyürüjét	jegygyűrűjét
jegönyefa	jegenyefa
jegönyefának	jegenyefának
jelenccs	jelents
jelentenyi	jelenteni
jelentyi	jelenti
jelentötte	jelentette
jelnetésében	jelentésében
jelzálog-bankja	jelzálogbankja
jelé	elé
jelënt	jelent
jer	gyere
jere	gyere
jertek	gyertek
jesztgetik	ijesztgetik
jmondta	mondta
jobbakval	jobbakkal
jobbná	jobbnál
jobbra-e	jobbra
jobbró	jobbról
johnson-nál	johnsonnál
joj	jaj
jovasolta	javasolta
juhak	juhok
juhakolbúl	juhakolból
juhakóba	juhakol
juhakól	juhakol
juliusban	júliusban
jun	jún.
junius	június
jutnyi	jutni
juttak	jutottak
juttunk	jutottunk
jáccani	játszani
jáccik	játszik
jáccogattam	játszogattam
jácodni	játszódni
jágëerho	jágerhoz
jáj	jaj
jándékot	ajándékot
jánnak	lánynak
jánt	lányt
jány	lány
jánya	lánya
jányka	lányka
jánynak	lánynak
jányok	lányok
jányokat	lányokat
jányoknak	lányoknak
jányokval	lányokkal
jányom	lányom
jányt	lányt
jányékhoz	lányékhoz
járkát	járkált
jármas	jármos
járnyi	járni
jártónk	jártunk
járáskelésbe	járás-kelésbe
jászojba	jászolba
jászolhó	jászolhoz
jászoly	jászol
jávor-szarvasfogakkal	jávorszarvasfogakkal
jégesső	jégeső
jégesű	jégeső
jégfelhőköt	jégfelhőket
jércéji	jércéje
jézús	jézus
jóakaratját	jóakaratát
jóindulatbúl	jóindulatból
jóindulatját	jóindulatát
jój	jaj
jókedvibe	jókedvébe
jókedvit	jókedvét
jókedvüen	jókedvűen
jókivánság	jókívánság
jókori	jókora
jólaktam	jóllaktam
jóllalktak	jóllaktak
jóltévőmöt	jótevőmet
jószántodból	jószántadból
jóságodér	jóságodért
jóságónkot	jóságunkat
jósóni	jósolni
jósúnak	jósolnak
jótettedér	jótettedért
jótétel	jótétel
jóu	jó
jóul	jól
józanyodnyi	józanodni
jóézűen	jóízűen
jóíz	íz
jóízüen	jóízűen
jóú	jól
jöhetök	jöhetek
jöhetők	jöhetek
jöjjöj	jöjjön
jönek	jönnek
jönn	jön
jösszte	jöszte
jösztök	jöttök
jöt	jött
jöttíl	jöttél
jövedőbelijök	jövendőbelijük
jövendőbelijët	jövendőbelijét
jövendőbelijöket	jövendőbelijüket
jövendőbélim	jövendőbelim
jövendőlnek	jövendölnek
jövendőlni	jövendölni
jövendőlését	jövendölését
jövevíny	jövevény
jövö	jövő
jövük	jövünk
jövőjit	jövőjét
júlusban	júliusban
jüjjetek	jöjjetek
jünni	jönni
jüttek	jöttek
jő	jön
jőjj	jöjj
jőjjenek	jöjjenek
jőjjön	jöjjön
jőne	jönne
jőnek	jönnek
jőni	jönni
jű	jön
jűjjek-menjek	jöjjek-menjek
jűne	jönne
kajabajálta	kiabálta
kajabolja	kiabálja
kajabolti	kiabálta
kajbolta	kiabálta
kajbál	kiabál
kajbálni	kiabálni
kajbált	kiabált
kajbálta	kiabálta
kajobálták	kiabálták
kakuk	kakukk
kakukfűvel	kakukkfűvel
kakukkól	kakukkol
kakukmadarat	kakukkmadarat
kakukol	kakukkol
kakukot	kakukkot
kakukszó	kakukkszó
kakuktól	kakukktól
kalapjárló	kalapjáról
kalitkástól	kalitkástul
kalitkástúl	kalitkástul
kalácssütísnek	kalácssütésnek
kalácstísztábúl	kalácstésztából
kampósbotomval	kampósbotommal
kanargó	kanyargó
kanáljával	kanalával
kaott	kapott
kapaszkoggyatok	kapaszkodjatok
kapján	kapuján
kapol	kapsz
kaptanak	kaptak
kaptt	kapott
kapujok	kapujuk
kapálnyi	kapálni
kapáni	kapálni
kapúra	kapura
karacsony	karácsony
kardjokat	kardjukat
karjábó	karjából
kartonpack-kal	kartonpackkal
karáconkor	karácsonykor
karácson	karácsony
kaszástló	kaszástól
katholikus	katolikus
katonaid	katonáid
katonakovártély	katonakvártély
katonpack	kartonpack
katonátúl	katonától
katulyás	skatulyás
katulyát	skatulyát
katulyáért	skatulyáért
kazalbó	kazalból
kazlostúl	kazlostul
kazálba	kazalba
kaóbaszt	kolbászt
kaóbászúk	kolbászuk
kebelibe	keblébe
kebeliben	kebelében
keblire	keblére
kecske-katonaság	kecskekatonaság
kedveskedésbő	kedveskedésből
kedveskönni	kedveskedni
kedvesöm	kedvesem
kedvesőm	kedvesem
kedvibe	kedvébe
kedvit	kedvét
kedvéra	kedvére
kedvödet	kedvedet
keetek	kendtek
kegyelmesenn	kegyelmesen
kegyemöd	kegyelmed
kegyetlenű	kegyetlenül
kehëlybe	kehelybe
kelcsük	keltsük
kelebibe	keblébe
kelebjéből	kebléből
keletkëzik	keletkezik
keletlen	keletlen
kellése	kelése
kelléses	keléses
kellést	kelést
kellésës	keléses
kellött	kellett
kemenbe	kemencébe
kemenczébe	kemencébe
kemenczét	kemencét
kement	kemencét
kemöncének	kemencének
kendeje	kendője
kendejével	kendőjével
kendermagát	kendermagját
kendír	kendért
kendőjit	kendőjét
kenyerekbűl	kenyerekből
kenyergem	könyörgöm
kenyeribő	kenyeréből
kenyerit	kenyerét
kenyerőnk	kenyerünk
kenyírirt	kenyérért
kenyírnek	kenyérnek
keravill-t	keravillt
kerbe	körbe
kerecsëndre	kerecsendre
kerekedeskereken	kereken
kerekes-	kerekes
kereknyomba	keréknyomba
kerengenek	kerengnek
keresell	keresel
kereskedel	kereskedsz
keresniök	keresniük
keresnyi	keresni
keresnëd	keresned
keressz	keresel
kerestyén	keresztény
kerestík	keresték
keresz	kereszt
kereszt-úthoz	keresztúthoz
keresztapjok	keresztapjuk
keresztapjuktó	keresztapjuktó
keresztapjáhó	keresztapjához
keresztapjátúl	keresztapjától
kereszteletlenűl	kereszteletlenül
keresztezisinél	kersztezésénél
kereszthe	kereszthez
kereszthö	kereszthez
kereszthő	kereszthez
kereszttűl	kereszttől
keresztuthoz	keresztúthoz
keresztutnál	keresztútnál
keresztutra	keresztútra
keresztutón	keresztúton
keresztölném	keresztelném
keresztútat	keresztutat
keresztülik	keresztelik
keresztől	keresztül
keresztű	keresztül
keresztűl	keresztül
keresztűldobják	keresztüldobják
keresztűllép	keresztüllép
keresztűlmentünk	keresztülmentünk
keresök	keresek
keringűt	keringőt
keritenek	kerítenek
keriteni	keríteni
kerittésin	kerítésén
keritésre	kerítésre
keritísenn	kerítésen
kertjekben	kertükben
kertji	kertje
kertjibe	kertjébe
kertjiben	kertjében
kertvégbül	kertvégből
kertísz	kertész
kertíszhez	kertészhez
kertíszi	kertészi
kertíszlakba	kertészlakba
kertíszlegíny	kertészlegény
kertíszlegínyhez	kertészlegényhez
kertíszlegínyt	kertészlegényt
kertísznek	kertésznek
kertíszt	kertészt
kertíszéknek	kertészéknek
kerüjön	kerüljön
kerülhettíl	kerülhettél
kerüll	kerül
kerüllő	kerülő
kerülté	kerültél
kerültíl	kerültél
kerű	kerül
kerűl	kerül
kerűlt	került
kerűt	került
kerűtem	kerültem
kesergéshe	kesergéshez
keserves-kinos	keserves-kínos
keservesenn	keservesen
keservibe	keservébe
keszkendő	keszkenő
keszkendőt	keszkenőt
ketten-hároman	ketten-hárman
kettonknek	kettőnknek
kettészakitotta	kettészakította
kettőharapott	kettéharapott
kettőjök	kettőjük
kettőjöket	kettőjüket
kettőjöknek	kettőjüknek
kettőjük	kettejük
keveredel	keveredsz
kevernyi	keverni
keves	kevés
kevesellette	kevesellte
kezdenyi	kezdeni
kezdjőnk	kezdjünk
kezdtík	kezdték
kezdëtt	kezdett
kezdött	kezdett
kezedrű	kezedről
kezedvel	kezeddel
kezefeje	kézfeje
kezefejjén	kézfején
kezefejét	kézfejét
kezemvel	kezemmel
kezi	keze
kezi-lába	keze-lába
kezibe	kezébe
keziben	kezében
keziből	kezéből
kezikbe	kezükbe
kezit	kezét
kezit-lábát	kezét-lábát
kezivel	kezével
kezsit	kezét
keztyűjét	kesztyűjét
kezték	kezdték
kezébő	kezéből
kezéhe	kezéhez
kezökben	kezükben
keőccsön	kölcsön
ki	ki
ki-mi	mi
kiabálnyi	kiabálni
kiabányi	kiabálni
kiabát	kiabált
kiabáta	kiabálta
kialudott	kialudt
kiannyi	kiadni
kibeszílte	kibeszélte
kibirja	kibírja
kibujék	kibújt
kibántá	kibántál
kibúhassak	kibújhat
kibújuk	kibújik
kibútt	kibújt
kibúvik	kibújik
kicseréllik	kicserélik
kicseréték	kicserélték
kicsinnyég	kicsinység
kicsiráztak	kicsíráztak
kicsínt	kicsit
kidhusz-nak	kidhusznak
kiduvadának	kidúvadának
kidüjjed	kidülled
kidüt	kidőlt
kidőt	kidőlt
kidűlt-bedűlt	kidőlt-bedőlt
kidűtöm	kidöntöm
kidűtötte	kidöntötte
kied	kend
kiedet	kegyelmedet
kiednek	kegyelmednek
kiedtől	kegyelmedtől
kiedé	kegyelmedé
kieg	kieg.
kiejtés-	kiejtés
kiengenni	kiengedni
kient	kend
kientnek	kendnek
kieresztlek	kieresztelek
kiesött	kiesett
kietek	kendtek
kieteknek	kendteknek
kifakadott	kifakadt
kifeküttünk	kifeküdtünk
kifeszitëtt	kifeszített
kifizetyi	kifizeti
kifogyék	kifogyott
kifordol	kifordul
kifurják	kifúrják
kifutatott	kifutott
kifáradott	kifáradt
kiguringatni	kigurigatni
kigyelmed	kegyelmed
kigyelmeddel	kegyelmeddel
kigyelmedet	kegyelmedet
kigyelmedhez	kegyelmedhez
kigyelmednek	kegyelmednek
kigyelmednél	kegyelmednél
kigyelmedtől	kegyelmedtől
kigyelmetek	kegyelmetek
kigyelmeteket	kegyelmeteket
kigyelmeteknek	kegyelmeteknek
kigyelmetektől	kegyelmetektől
kigyulad	kigyullad
kigyó	kígyó
kigyóbőrt	kígyóbőrt
kigyógyúl	kigyógyul
kigyót	kígyót
kigyóval	kígyóval
kigyöhetsz	kijöhetsz
kigyön	kijön
kigyött	kijött
kigyöttünk	kijöttünk
kigyüjjön	kijöjjön
kigyünni	kijönni
kigyütt	kijött
kigyüttek	kijöttek
kigyüttünk	kijöttünk
kihagyította	kihajította
kihanyítom	kihajítom
kihanyítottam	kihajítottam
kihanyították	kihajították
kihuták	kihúzták
kihuzza	kihúzza
kihuzzák	kihúzzák
kihánni	kihányni
kihánta	kihányta
kihírdettík	kihirdették
kihíta	kihívta
kihítta	kihívta
kihótak	kihaltak
kihúll	kihull
kihülés	kihűlés
kijelentötte	kijelentette
kijózanogyik	kijózanodik
kijő	kijön
kike	kikel
kiki	ki-ki
kikiril	kukorékol
kikiríkulta	kukorékolta
kikiseér	kikísér
kikászalódni	kikászálódni
kikésérték	kikísérték
kiköltözködének	kiköltözködtek
kikötte	kikötötte
kiküldötték	kiküldték
kikő	kikel
kikől	kikel
kikőt	kikelt
kilecvenkilen-cedik	kilecvenkilencedik
kilencvenegyikbe	kilencvenedik
kilencvenkilncet	kilencvenkilencet
kilessi	kilesi
kilincsihez	kilincséhez
kilises	keléses
kilíp	kilép
kilódittám	kilódítottam
kilövellkedett	kilövelkedett
kilüvi	kilövi
kimarkól	kimarkol
kimegyen	kimegy
kimene	kiment
kimenek	kimegyek
kimennyi	kimenni
kimenyek	kimegyek
kimenyen	kimegy
kimulása	kimúlása
kimén	kimegy
kimírette	kimérette
kimögyök	kimegyek
kimönni	kimenni
kimönnének	kimennének
kimönt	kiment
kimönyön	kimegy
kimúlatta	kimulatta
kincseskamarába	kincseskamrába
kincseskamarában	kincseskamrában
kincseskamarádba	kincseskamrádba
kincseskamarájából	kincseskamrájából
kincsiírt	kincséért
kincssel	kinccsel
kincsset	kincset
kincséér	kincséért
kincsöket	kincseket
kincsöt	kincset
kinderjük	kenderjük
kinjában	kínjában
kinlódj	kínlódj
kinnal	kínnal
kinnt	kint
kinozza	kínozza
kintlévőségi	kintlévőségei
kinyajják	kinyalják
kinyeredet	kenyeredet
kinyerem	kenyerem
kinyeret	kenyeret
kinyilik	kinyílik
kinyillik	kinyílik
kinyitani	kinyitni
kinyitaná	kinyitná
kinyitta	kinyitotta
kinyitták	kinyitották
kinyérdombnak	kenyérdombnak
kinyérétt	kenyérért
kinzás	kínzás
kinzó	kínzó
kinálja	kínálja
kinállya	kínálja
kinálták	kínálták
kinálunk	kínálunk
kiné	kinél
kinë	kinél
kiníz	kinéz
kinízett	kinézett
kinízni	kinézni
kinózta	kínozta
kinövísre	kinövésre
kinőttt	kinőtt
kipihentík	kipihenték
kipocscsan	kipottyan
kiprobávo	kipróbálva
kipzik	képezik
kirepödözve	kirepedezve
királ	király
királhon	királyhoz
királhoz	királyhoz
királi	királyi
királkisasszonynak	királykisasszonynak
királra	királyra
királyasszonyná	királyasszonynál
királyfiakot	királyfiakat
királyfijának	királyfiának
királyfirúl	királyfiról
királyfiu	királyfiú
királyfiunak	királyfiú
királyfiut	királyfiút
királyja	királya
királykiasszonynak	királykisasszonynak
királykisassznny	királykisasszony
királykisasszonyho	királykisasszonyhoz
királykisasszonytúl	királykisasszonytól
királykisaszonnyal	királykisasszonnyal
királykisaszszony	királykisasszony
királyleán	királyleány
királyná	királynál
királyného	királynéhoz
királynéjátó	királynéjától
királynéjé	királynéé
királytúl	királytól
királyval	királlyal
királyúrfitúl	királyúrfitól
kis-kanász	kiskanász
kisasszonka	kisasszonyka
kisbornyúja	kisborjúja
kisbornyút	kisborjút
kiscselédöm	kiscselédem
kiscsikaja	kicsikója
kiscsikajának	kiscsikójának
kiscsíkó	kiscsikó
kisebbitse	kisebbítse
kisfiuk	kisfiúk
kisgyerekemvel	kisgyerekemmel
kisgyerekinek	kisgyerekének
kisgyerekit	kisgyerekét
kisgyerëkët	kisgyereket
kishasznon-gépjárművet	kishasznongépjárművet
kisjány	kislány
kiskorába	kiskorában
kissurrant	kisurrant
kisujjadró	kisujjadról
kisujjáró	kisujjáról
kisujszállási	kisújszállási
kisvarangynak	kisvarangynak
kisvágtatva	kisvártatva
kisz	kis
kiszabadithatta	kiszabadíthatta
kiszabadittám	kiszabadítám
kiszaladott	kiszaladt
kiszegeőttettek	kiszegődtetek
kiszítta	kiszívta
kiszűlt	kiszült
kisére	misére
kisérje	kísérje
kisérletek	kísérletek
kisérletezés	kísérletezés
kisértet	kísértet
kisértetek	kísértetek
kisértetet	kísértetet
kisértetről	kísértetről
kisértettől	kísértettől
kisöccsi	kisöccse
kisöccsinek	kisöccsének
kisöccsitő	kisöccsétől
kisöccsitől	kisöccsétől
kisütnyi	kisütni
kisőn	későn
kitalju	kitanulja
kitanittatta	kitaníttatta
kitanálod	kitalálod
kitanálsz	kitalálsz
kitanálta	kitalálta
kitanálták	kitalálták
kitanányi	kitalálni
kitellik	kitelik
kitellék	telt
kiteritett	kiterített
kiteritve	kiterítve
kitunő	kitűnő
kitur	kitúr
kity-koty	kitty-kotty
kitëpik	kitépik
kitípi	kitépi
kitírő	kitérő
kitöltőd	kitöltöd
kitötésvel	kikötéssel
kitűztík	kitűzték
kivirët	kivirágzik
kiviszesz	kiviszel
kivonszolnyi	kivonszolni
kiválaszott	kiválasztott
kiválasztá	kiválasztotta
kiválék	kiválik
kiváncsi	kíváncsi
kiváncsiak	kíváncsiak
kiváncsian	kíváncsian
kiváncsiság	kíváncsiság
kiváncsiságot	kíváncsiságot
kivánd	kívánd
kivánhat	kívánhat
kivánhatsz	kívánhatsz
kivánja	kívánja
kivánna	kívánna
kivánok	kívánok
kivánom	kívánom
kivánsz	kívánsz
kivánság	kívánság
kivánsága	kívánsága
kivánságod	kívánságod
kivánságok	kívánságok
kivánságokat	kívánságokat
kivánságomat	kícánságomat
kivánságot	kívánságot
kivánságuk	kívánságuk
kivánságához	kívánságához
kivánságát	kívánságát
kivánt	kívánt
kivántál	kívántál
kivönni	kivenni
kivötte	kivette
kivül	kívül
kivülről	kívülről
kiállani	kiállni
kiállanod	kiállnod
kiállittassa	kiállíttassa
kiáltanyi	kiáltani
kiáltnak	kiáltanak
kiáltonak	kiáltanak
kiáltottá	kiáltotta
kiátnak	kiáltanak
kiátott	kiáltott
kiátottam	kiáltottam
kiátozni	kiáltozni
kiátoztuk	kiáltoztuk
kiátson	kiáltson
kiáttsák	kiáltsák
kiáták	kiáltották
kiéi	kié
kiészen	készen
kiészülődések	készülődések
kiíheztetett	kiéheztetett
kiírjenek	kiérjenek
kiírkezett	kiérkezett
kiírtek	kiértek
kiódta	kioldta
kiódzott	kioldozódott
kiótotta	kioltotta
kiöblitik	kiöblítik
kiüsmerszik	kiismerszik
kiütyi	kiüti
kiőtözött	kiöltözött
kiűztík	kiűzték
kluwe	kluwer
kobakjáró	kobakjáról
kocsijok	kocsijuk
kocsikval	kocsikkal
kocsissát	kocsisát
kocsistúl	kocsistól
kocsiódalt	kocsioldalt
kocsmábó	kocsmából
kocsmárosfamilia	kocsmárosfamília
kocza	koca
kokas	kakas
kokasnak	kakasnak
kokorékok	kukorékok
kokosok	kakasok
kolbászval	kolbásszal
koldusgunyába	koldusgúnyába
kolduskölke	kolduskölyke
koldús	koldus
koldúshó	koldushoz
koldúsnak	koldusnak
koldúsok	koldusok
koldústúl	koldustól
kollinta	kólintott
kollintja	kólintja
kolégyomba	kollégiumba
komaasszonyáér	komaasszonyáért
komaék	komáék
komaékho	komáékhoz
komediásnak	komédiásnak
komendáták	kommendálták
komja-asszonya	komaasszonya
kommandérozta	kommandírozta
kommandérozza	kommandírozza
kommenciút	kommenciót
kommondort	komondort
komra	kamra
komrába	kamrába
komrábó	kamrából
komránkbó	kamránkból
komájáhó	komájához
komám-asszony	komámasszony
komédiázzá	komédiázz
kondúl	kondul
konjunktúra-jelentésében	konjunktúrajelentésében
konyhóhoz	kunyhóhoz
konytyát	kontyát
kopacz	kopasz
koponyámot	koponyámat
koporsóbó	koporsóból
koporsóho	koporsóhoz
koppintanyi	koppintani
korbaccsaó	korbáccsal
korbácsútak	korbácsoltak
korsójábúl	korsójából
korsóva	korsóval
korábó	korából
korájig	koráig
koszom	köszön
koszorujából	koszorújából
koszoruná	koszorúnál
koszorut	koszorút
koszorót	koszorút
kotkodájjon	kotkodáljon
kotlanyi	kotlani
kováccsó	kovácssal
kovácsho	kovácshoz
kovártélyt	kvártélyt
kovártérozták	kvártélyozták
krajcárjok	krajcárjuk
krakognak	krákognak
kristály-tőr	kristálytőr
krisztuls	krisztus
krisztussa	krisztussal
krumplivaó	krumplival
krúmpli	krumpli
kuczkóba	kuckóba
kufferjábul	kofferjából
kuikkolnak	kuvikolnak
kukorica-istennő	kukoricaistennő
kukorica-jegyzések	kukoricajegyzések
kukoricaajegyzések	kukoricajegyzés
kukoricáhó	kukoricához
kukorikolnak	kukorékolnak
kukorikolni	kukorékolni
kukorëkol	kukorékol
kukoríkul	kukorékol
kukoríkúl	kukorékol
kukoríkúnak	kukorékolnak
kukuricát	kukoricát
kukurikolhatsz	kukorékolhatsz
kukurikolsz	kukorékolsz
kukurikolt	kukorékolt
kukurikolását	kukorékolását
kukuriku	kukurikú
kukurikul	kukorékol
kulcsjuk	kulcslyuk
kulcsjukon	kulcslyukon
kulcsjuktól	kulcslyuktól
kulcsjukán	kulcslyukán
kulcslikán	kulcslyukán
kulcslukba	kulcslyukba
kulcslukon	kulcslyukon
kuldulásával	koldulásával
kummmantást	kummantást
kunmadaras	Kunmadaras
kunyhóbló	kunyhóból
kunyhóbúl	kunyhóból
kunyoráljon	kunyeráljon
kunyorált	kunyerált
kunyoráltak	kunyeráltak
kupábúl	kupából
kuratyolását	kuruttyolását
kut	kút
kutagumit	kutyagumi
kutba	kútba
kutban	kútban
kutból	kútból
kuthoz	kúthoz
kutnál	kútnál
kuton	kúton
kutra	kútra
kuttya	kutya
kuttól	kúttól
kutya-bejáráson	kutyabejáráson
kutya-lakodalmat	kutyalakodalmat
kutyabűrdudások	kutyabőrdudások
kutyagyerekőnk	kutyagyerekünk
kutyakölyket	kutyakölyköt
kutyádtúl	kutyádtól
kutyájok	kutyájuk
kutyástúl	kutyástul
kutyátúl	kutyától
kutyáér	kutyáért
kuvikk	kuvik
kuvikkol	kuvikol
kyoceranak	kyocerának
káboszta	káposzta
kábosztát	káposztát
kácsa	kacsa
kácsák	kacsák
kácsákat	kacsákat
kálha	kályha
kántortanitót	kántortanítót
káposzta-házacskában	káposztaházacskában
káposztábúl	káposztából
káprádzani	káprázni
káprádzott	káprázott
károsodjónk	károsodjunk
kárré	kárért
kéccé	kétszer
kécs	két
kékpiros	kékpiros
kéménybő	kéményből
kéménybűl	kéményből
kénccsel	kinccsel
kéncsöm	kincsem
kénos	kínos
kénszerítette	kényszerítette
kényelmit	kényelmét
kényök-kedvök	kényük-kedvük
kéná	kínál
kénál	kínál
kénálta	kínálta
képibe	képébe
képiben	képében
képire	képére
képit	képét
képzelődöl	képzelődsz
képömre	képemre
kérde	kérdi
kérdette	kérdezte
kérdeznyi	kérdezni
kérdeztík	kérdezték
kérdezzse	kérdezze
kérdezé	kérdezte
kérdezősködöl	kérdezősködsz
kérdésire	kérdésére
kérdísemre	kérdésemre
kérdözi	kérdezi
kérdözte	kérdezte
kérdözék	kérdezék
kéreccett	kéredzkedett
kéregetnyi	kéregetni
kérezett	kérdezkedett
kérjé	kérjél
kérnyi	kérni
kértelte	kérlelte
kérésödet	kérésedet
kéröm	kérem
kérőkvel	kérőkkel
késedelmezött	késedelmezett
késivel	késével
késse	késsel
készenl	készen
készit	készít
készitik	készítik
készités	készítés
készön	készen
készüjjön	készüljön
készülniök	készülniük
későbben	később
kételenség	képtelenség
kételkedel	kételkedsz
kétmillárd	kétmilliárd
kéttséges	kétséges
kétódalba	kétoldalba
kétökröshön	kétökröshöz
kévánja	kívánja
kévánságára	kívánságára
kévánta	kívánta
kévánták	kívánták
kézibe	kezébe
kéziben	kezében
kézmíves	kézműves
këll	kell
këllëtt	kellett
kërësztbe	keresztbe
kí	ki
kíbírja	kibírja
kígyuját	kígyóját
kíjönnek	kijönnek
kímenyen	kimegy
kímínyënn	kimegy
kíncsökön	kincseken
kíncsöt	kincset
kínlódhatánk	kínlódhattunk
kínlóudtunk	kínlódtunk
kínálik	kínálja
kípes	képes
kípibe	képébe
kír	kér
kírd	kérd
kírded	kérded
kírdezi	kérdezi
kírdezte	kérdezte
kírdeztík	kérdezték
kíred	kéred
kírek	kérek
kírelte	kérlelte
kírem	kérem
kíri	kéri
kírje	kérje
kírjem	kérjem
kírjél	kérj
kírjíl	kérjél
kírlek	kérlek
kírleli	kérleli
kírlelte	kérlelte
kírlelísre	kérlelésre
kírnek	kérnek
kírni	kérni
kírsz	kérsz
kírt	kért
kírte	kérte
kírtem	kértem
kírályúrfi	királyúrfi
kís	kis
kísz	kész
kíszen	készen
kíszitik	készítik
kíszsíggel	készséggel
kíszíteni	készíteni
kíszítenyi	készíteni
kíszítettél	készítettél
kíszítettík	készítették
kíszíts	készíts
kíszíttessen	készíttessen
kíszíttetett	készíttetett
kíszítve	készítve
kísönn	későn
kít	kit
kível	kívül
kívelrő	kívülről
kíverrő	kívülről
kívánkozhatik	kívánkozhat
kívülem	kívül
kívűl	kívül
kízfogással	kézfogással
kóboról	kóborló
kóbásszuk	kolbászuk
kócs	kulcs
kócslyukon	kulcslyukon
kócsot	kulcsot
kódis	koldus
kódisság	koldusság
kódult	koldult
kódulásból	koldulásból
kódus	koldus
kódusnak	koldusnak
kódustarisznyából	koldustarisznyából
kódús	koldus
kódúsnak	koldusnak
kópia-igazoltatást	kópiaigazoltatást
kópja-fa	kopjafa
kórogy	kórógy
kóstollya	kóstolja
kótelet	kötelet
kótlója	kotlója
köcsögbü	köcsögből
ködmenke	ködmönke
ködmenkéje	ködmönkéje
ködömönünk	ködmönünk
köjkök	kölykök
köl	kell
köles-kásával	köleskásával
köllene	kellene
köllök	kellek
köllött	kellett
költöztettík	költöztették
kölykek	kölykök
könnyü	könnyű
köntössiből	köntöséből
könycsepp	könnycsepp
könycseppet	könnycseppet
könyebben	könnyebben
könyered	kenyered
könyeret	kenyeret
könyökit	könyökét
könyörgísre	könyörgésre
könyőkülni	könyökölni
köpenyegjét	köpenyegét
köpönyegit	köpönyegét
köpüre	köpűre
köpűlés	köpülés
köpűlőt	köpülőt
körbő	körből
köribe	körébe
körmit	körmét
körmive	körmével
környezett	környezetet
körti	körte
körtifa	körtefa
körtifárúl	körtefáról
köréjé	köréje
köröskörül	körös-körül
köröszbe	keresztbe
körösztbe	keresztbe
körösztöket	kereszteket
körösztölni	keresztelni
körösztöt	keresztet
körösztül	keresztül
körösztülik	keresztelik
körösztüllépted	keresztüllépted
körösztülmennem	keresztülmennem
körösztülőrű	keresztelőről
körösztű	keresztül
körötte	körülötte
körözvén	körözvény
köröő	körül
körülelik	körülölelik
körülhordgya	körülhordja
körülötted	körülötte
körűfogták	körülfogták
körűjárni	körüljárni
körűkapták	körülkapták
körűl	körül
körűlfordúl	körülfordul
körűlmegy	körülmegy
körűlnyomkodja	körülnyomkodja
körűnézek	körülnézek
körűnézett	körülnézett
kössé	köss
kösség	község
kössë	kösse
köst	kösd
köszvinnek	köszvénynek
köszöbjén	küszöbén
köszönnyi	köszönni
köszöntésire	köszöntésére
köszőn	köszön
köteje	kötele
kötejét	kötelét
kötelességit	kötelességét
kötelezettség-állománya	kötelezettségállománya
kötelit	kötelét
kötinnye	köténye
kötinyit	kötényét
kötnyi	kötni
kötte	kötötte
köttek	kötöttek
köttem	kötöttem
kötték	kötötték
köttík	kötötték
kötéltül	kötéltől
köténnyét	kötényét
kötényibe	kötényébe
kötényit	kötényét
kötőfékit	kötőfékét
kötőfík	kötőfék
kötőfíket	kötőféket
kötőrúdat	kötőrudat
kötőttík	kötötték
követjei	követei
követjeiket	követeiket
követkëző	következő
követyi	követi
kövit	kövét
kövírebb	kövérebb
közben-közben	közben
közbürső	közbülső
közdenek	küzdenek
közelebb-közelebb	közelebb
közelebbrű	közelebbről
közeledbe	közelbe
közeledben	közelben
közeledö	közeledő
közeledött	közeledett
közelezettséget	kötelezettségét
közelibe	közelébe
közeliben	közelében
közelittünk	közelítünk
közelébb	közelebb
közelébb-közelébb	közelebb-közelebb
közelőnkbe	közelünkbe
közepibe	közepébe
közepiben	közepében
közepin	közepén
közepinn	közepén
közepire	közepére
közepit	közepét
közepső	középső
közepíbe	közepében
közibénk	közénk
közibük	közéjük
közin	közén
köztek	köztetek
közzeledik	közeledik
közzepibe	közepébe
közzepiben	közepében
közzepibűl	közepéből
közzepin	közepén
közzül	közül
közébük	közéjük
közél	közel
középsőhö	középső
középsőét	középső
középön	középen
közétenni	közzétenni
közölük	közülük
közönségös	közönséges
közössen	közösen
közülletek	közületek
közülök	közülük
közűl	közül
köű	kell
kúcsjukon	kulcslyukon
kúcslyukon	kulcslyukon
kúcsot	kulcsot
kúcsunk	kulcsunk
kúdulni	kuldulni
kúdus	koldus
kúdusnak	koldusnak
kúdust	koldust
kúdustúl	koldustól
kútakban	kutakban
kútbú	kútból
kútbúl	kútból
kútya	kutya
kútyát	kutyát
kü	kell
küdöm	küldöm
küldélek	küldtelek
külykiét	kölykét
külyök	kölyök
külömbnél	különbnél
külömbségből	különbségből
különböz	különbözik
külül	kívül
künn	kinn
künnek	küldenek
künnvaló	kinnvaló
künt	kint
küpülték	köpülték
kürtjit	kürtjét
kürtőbő	kürtőből
kürtűve	kürtölve
küsasszony	kisasszony
küsasszonynál	kisasszonynál
küsasszonyt	kisasszonyt
küsasszonytól	kisasszonytól
küsebbik	kisebbik
küsruhája	kisruhája
küsruhájába	kisruhájába
küsruhájából	kisruhájából
küsruhát	kisruhát
küssebb	kisebb
küssebbik	kisebbik
küsség	kisség
küszködís	küszködés
küszöbin	küszöbén
küszöbëre	küszöbére
küszöghö	küszöbhöz
küszögin	küszöbén
kütta	kiitta
küzdenyi	küzdeni
küzdik	küzd
küzdöl	küzdesz
küzdöttíl	küzdöttél
küzeledett	közeledett
küzködnyi	küszködni
küzsdenek	küzdenek
küzsdeni	küzdeni
küzsdött	küzdött
küő	kő
kőccsél	költsél
kőccsön	kölcsön
kőhö	kőhöz
kől	kell
kőlajkitermelési	kőolajkitermelési
kőll	kell
kőmíveslegény	kőműveslegény
kőmíveslegényeket	kőműveslegényeket
kőr	kör
kőtek	keltek
kőteni	költeni
kőtetnek	keltetnek
kőtik	keltik
kőtségekre	költségekre
kőtt	kelt
kőttségit	költségét
kőttségünköt	költségünket
kőttsön	költsön
kőttsük	költsük
kőtölek	költelek
kőtöm	keltem
kőtötte	keltette
kőtötted	keltetted
kőtöttek	keltettek
kű	kő
kűbe	kőbe
kűbálvány	kőbálvány
kűbálványhoz	kőbálványhoz
kűbálványnak	kőbálványnak
kűbálványokat	kőbálványokat
kűbálványt	kőbálványt
kűdd	küldd
kűdeni	küldeni
kűdetett	küldetett
kűdheti	küldheti
kűdj	küldj
kűdjön	küldjön
kűdte	küldte
kűdtek	küldtek
kűdté	küldtél
kűdték	küldték
kűdélek	küldtelek
kűdök	küldök
kűdött	küldött
kűmorzsoló	kőmorzsoló
kűmorzsolót	kőmorzsolót
kűszikla	kőszikla
kűsziklán	kősziklán
kűtték	küldték
l'oreal	l'oréal
l9	19
labat	lábat
lagzihó	lagzihoz
lakadalma	lakodalma
lakadalmadra	lakodalmadra
lakadalmat	lakodalmat
lakadalmi	lakodalmi
lakadalmába	lakodalmában
lakadalmát	lakodalmát
lakadalom	lakodalom
lakadalomnak	lakodalomnak
lakadalomra	lakodalomra
lakatkócsot	lakatkulcsot
lakbúl	lakból
lakhatik	lakhat
lakodalmoztak	lakodalmaztak
lakomározást	lakmározást
lakozhatik	lakozhat
lakozék	lakozott
laktanak	laktak
lakzis	lagzis
lakzit	lagzit
lakáshitel-kamatot	lakáshitelkamat
lakástakarék-pénztárak	lakás-takarékpénztár
lakástakarékpénztár	lakás-takarékpénztár
lakóssait	lakosait
langot	lángot
lapickával	lapockával
lapis	lapos
lapittó	lapító
laskanyútót	laskanyújtót
lassankint	lassanként
lasssult	lassult
lavorba	lavórba
lazaretbe	Lazaretbe
leakasztanyi	leakasztani
learatattak	learatztak
leboritanak	leborítanak
leboritják	leborítják
leburitotta	leborította
lebúrítanak	leborítanak
lecsüngetött	lecsüngetett
ledőntik	ledöntik
ledűlt	ledőlt
leereszködtek	leereszkedtek
lefeküdött	lefeküdt
lefeküsznek	lefekszenek
lefekütt	lefeküdt
lefeküvék	lefeküdt
lefetyüli	lefetyeli
leffellé	lefelé
lefoly	lefolyik
legalul	legalul
legalábbvaló	legalávalóbb
legalól	legalul
legbelő	belül
legeji	legeli
legek	legek
legelnyi	legelni
legelon	legelőn
legelore	legelőre
legelsőbben	legelőször
legelébb	legelőbb
legelészszenek	legelésszenek
legelőröl	legelőről
legelőrül	legelőről
legelőrűl	legelőről
legelősször	legelőször
legeény	legény
legfennebb	legfentebb
legföljebb	legfeljebb
leghamarább	leghamarabb
leghamarébb	leghamarabb
leghamrabb	leghamarabb
legienyek	legények
leginy	legény
leginyek	legények
legislegszebb	legeslegszebb
legiény	legény
legiényei	legényei
legiények	legények
legiényeket	legényeket
legiénység	legénység
legkissebbik	legkisebbik
legkissebbér	legkisebbért
legküssebb	legkisebb
legküssebbik	legkisebbik
legküssebbiket	legkisebbiket
legmagossabb	legmagasabb
legmeredekjebb	legmeredekebb
legszöbbjeiből	legszebbjeiből
legubaszt	legubbaszt
legugsoltam	lekuksoltam
legviégién	legvégén
legy	légy
legyetök	legyetek
legyezgesség	legyezgessék
legyén	legyen
legyön	legyen
legyött	lejött
legyün	lejön
legyütt	lejött
legyüttek	lejöttek
legyőnk	legyünk
legyűn	lejön
legéneknek	legényeknek
legénke	legényke
legénkori	legénykori
legénkorába	legénykorában
legénnek	legénynek
legénsorba	legénysorba
legént	legényt
legénybül	legényből
legényektő	legényektől
legényi	legénye
legénykoráben	legénykorában
legényrő	legényről
legényvel	legénnyel
legéyn	legény
legíny	legény
legínyeket	legényeket
legínykori	legénykori
legöregebbvel	legöregebbel
lehajult	lehajolt
lehassogatta	lehasogatta
lehecséges	lehetséges
lehelletet	leheletet
lehelletével	leheletével
lehetetlensíget	lehetetlenséget
lehetött	lehetett
lehuzza	lehúzza
lehántyák	lehántják
lehúll	lehullik
lehül	lehűl
leirom	leírom
leirva	leírva
lejebb	lejjebb
lejereszkedett	leereszkedett
lejereszkedik	leereszkedik
lejjebb-lejjebb	lejjebb
lejányt	leányt
lejártokon	lejáratokon
lekissebbítenek	lekisebbítenek
leküldötték	leküldték
leküpködnek	leköpködnek
lekűdte	leküldte
lelköm	lelkem
lelípnek	lelépnek
lelűnni	lelőni
lelűve	lelőve
lemegyen	lement
lementében	mentében
lemenyen	lemegy
lemerűl	lemerül
lemiere	lemierre
lemmiere	lemierre
lennebb	lejjebb
lennyi	lenni
lenyirt	lenyírt
lenyugosznak	lenyugszanak
lenyúgtakor	lenyugtakor
leníz	lenéz
lepedoben	lepedőben
lepreczkelsz	lespriccelsz
lepëdeővel	lepedővel
leraknyi	lerakni
leroskadott	leroskadt
leselkedel	leselkedsz
leskülődött	leskelődött
lessz	lesz
leszakit	leszakít
leszakittatik	leszakíttatik
leszen	lesz
leszk	lesz
leszurni	leszúrni
leszállanak	leszállnak
leszállitotta	leszállította
leszállottá	leszálltál
leszöl	leszel
lesző	leszel
letalabb	legalább
leteleő	legelőször
letellett	letelt
letereősebb	legerősebb
letettík	letették
letjobban	legjobban
letkönnyebb	legkönnyebb
lettenek	lettek
letérgyelt	letérdelt
letörülni	letörölni
letörülte	letörölte
letötte	letette
leugrott	leugrott
leveledzőlap	levelezőlap
levelit	levelét
levelnek	levélnek
levelyi	levelei
leverenda	reverenda
leverendát	reverendát
levettík	levették
levidd	levidd
levivel	levével
levié	levél
levágnyi	levágni
leválott	levált
levélrűl	levélről
levőben	levő
lezárút	lezárult
leán	leány
leánból	leányból
leánnak	leánynak
leánnézőbe	leánynézőbe
leánt	leányt
leány-nevet	leánynevet
leányodot	leányodat
leányomot	leányomat
leánytestvíreket	leánytestvéreket
leánytestvírit	leánytestvérét
leánytestvírünket	leánytestvérünket
leányvállathoz	leányvállalathoz
leányátúl	leányától
leátak	leálltak
leépsz	lépsz
leígette	leégette
leíltík	leélték
leütte	leütötte
leőt	leölt
leűlt	leült
leűtek	leültek
lhagya	elhagyja
licendíjon	licencdíjon
lidercek	lidércek
liktyát	likját
lisztbő	lisztből
lisztőnk	lisztünk
liván	litván
liát	libát
liényok	lányok
lolábat	lólábat
lopakodhatol	lopakodhatsz
lopnyi	lopni
lovakot	lovakat
lovastúl	lovastul
lováró	lováról
luca	Luca
lucanap	luca-nap
lucanapkor	luca-napkor
lud	lúd
ludas-kását	ludaskását
ludhust	lúdhúst
ludtrágyát	lúdtrágyát
ludvérc	lidérc
ludvérczre	lidércre
lugosba	lugasba
lugzottak	lúgoztak
luváról	lováról
lyukbló	lyukból
lyukbúl	lyukból
lyukná	lyuknál
lyukábaó	lyukából
lyánba	lányba
lyánho	lányhoz
lyánnak	lánynak
lyánt	lányt
lyántó	lánytól
lyánynak	lánynak
lábafejére	lábfejére
lábamot	lábamat
lábamval	lábammal
lábaszára	lábszára
lábaszárára	lábszárára
lábaszőrzete	lábszőrzete
lábikhoz	lábukhoz
lábod	lábad
lábodat	lábadat
lábok	lábak
lábokat	lábukat
lábomat	lábamat
lábommal	lábammal
lábtó	lábtól
lábu	lábú
lábám	lábam
lábárul	lábáról
lábáró	lábáról
lábárúl	lábáról
lábúját	|lábujját
láccik	látszik
láccott	látszott
ládábúl	ládából
láncaó	lánccal
lángokval	lángokkal
lány-nevet	lánynevet
lányho	lányhoz
lánynízőbe	lánynézőbe
lányodot	lányodat
lányodtúl	lányodtól
lányodval	lányoddal
lányomval	lányommal
lánytestvíre	lánytestvére
lányánó	lányánál
lányónk	lányunk
lányüdét	lányodét
lápbló	lápból
lármáró	lármáról
lássonak	lássanak
láthati	láthatja
látniok	látniuk
látnyi	látni
látomásaji	látomásai
látszódjík	látszódjék
láttya	látja
láttyuk	látjuk
látytya	látja
léadja	leadja
légitársasaság	légitársaság
légitársaságokok	légitársaságok
légytol	légytől
légyvel	léggyel
léhütő	léhűtő
lél	lel
lélegzeti	lélegzete
lélegzetvisszafojtva	lélegzet-visszafojtva
lélekzetvétele	lélegzetvétele
lépjükben	lépükben
lépjőnk	lépjünk
lépésrő	lépésről
lépött	lépett
lépőnk	lépünk
léssz	leszel
lész	leszel
léttyire	létére
lë	le
lëgyek	legyek
lëgyeék	legyen
lëgyën	legyen
lëhet	lehet
lëhettem	lehettem
lëjjebb	lejjebb
lëmorzsonyi	lemorzsolni
lënnyi	lenni
lënnëm	lennem
lëpik	lepik
lëssz	lesz
lësz	lesz
lëtelepszeőnk	letelepszünk
lëtt	lett
lëttem	lettem
lëtörüjük	letöröljük
lëvert	levert
lëvágno	levágni
lëvágnyi	levágni
lëánt	lányt
líba	liba
lígy	légy
líp	lép
lípcsőnek	lépcsőnek
lípett	lépett
lípj	lépj
lípni	lépni
lípísre	lépésre
lípíst	lépést
lódarázst	lódarazsat
lódithassák	lódíthassák
lóhalálába	lóhalálában
lóhert	lóherét
lóho	lóhoz
lóhugyba	lóhúgyba
lónn	lovon
lótul	lótól
lögyenek	legyenek
lögyél	legyél
lögyön	legyen
löhet	lehet
löhetett	lehetett
löl	lett
lölt	lelt
lönni	lenni
lössz	lesz
lösz	lesz
löszök	leszek
löszön	lesz
lött	lett
lövésétt	lövésért
lú	ló
lúca	luca
lúcázni	lucázni
lúdakat	ludakat
lúdarázs	lódarázs
lúgzotta	lúgozta
lúháton	lóháton
lúhátra	lóhátra
lúkoponya	lókoponya
lúkoponyát	lókoponyát
lúnak	lónak
lúnál	lónál
lúpatkó	lópatkó
lúpatkót	lópatkót
lúra	lóra
lúrul	lóról
lúrúl	lóról
lúval	lóval
lütt	lőtt
lüvés	lövés
lüvök	lövök
lüődöznek	lődöznek
lőjjön	lőjön
lőtessük	lövessük
lőtőn	lejtőn
lű	lő
lűdd	lődd
lűttek	lőttek
ma-hónap	maholnap
macska-béka	macskabéka
macska-kölykek	macskakölykök
macskatüvisekbe	macskatövisekbe
macskatüviskbe	macskatöviskbe
macsko	macska
macskákot	macskákat
macskáktúl	macskáktól
macsáért	macskáért
madarastúl	madarastul
madjd	majd
madzagjábó	madzagjából
madárfiokák	madárfiókák
madárfiszek	madárfészek
madártollut	madártollat
madárír	madárért
maga-magának	magamagának
magadot	magadat
magadrúl	magadról
magamot	magamat
magamval	magammal
magaában	magában
magaé	magáé
magaét	magáét
magik	maguk
magikot	magukat
magokná	maguknál
magokot	magukat
magokra	magukra
magokró	magukról
magos	magas
magosan	magasan
magosba	magasba
magosra	magasra
magoss	magas
magossan	magasan
magukot	magukat
magukér	magukért
magyarázatja	magyarázata
magyarót	mogyorót
magyraországon	magyarországon
magzatjainak	magzatainak
magzatjának	magzatának
magáho	magához
magáhó	magához
magállani	megállni
magáná	magánál
magárló	magáról
magárúl	magáról
magátúl	magától
mahónap	maholnap
maig	máig
makacskodástok	makacskodásotok
maköt	makkot
malacca	malaca
malahit	malachit
malahitból	malachitból
malomja	malma
mannyország	mennyország
maradatok	maradjatok
maradott	maradt
maradvái	maradványai
maradváink	maradványaink
maradváinknak	maradványainknak
maradíkbúl	maradékból
maraggyanak	maradjanak
maraggyatok	maradjatok
maraggyék	maradjon
marcangolástúl	marcangolástól
mardosóstul	mardosástól
marhájokat	marhájukat
marjára	marára
markokba	markukba
markúljon	markoljon
marékval	marékkal
masiná	masina
masinábul	masinából
mast	most
maszszárítasz	megszárítasz
matáv-ot	matávot
matóllál	motollál
matóllált	motollált
matóllát	motollát
maá	már
maónosbébe	mónosbélbe
mcdonaldís	mcdonald's
mediobanca-é	mediobancáé
medribe	medrébe
medriből	medréből
meffognyi	megfogni
meg-megszentele	meg-megszentelte
meg-találta	megtalálta
megaggyonistenelnek	megadjonistenelnek
megakadott	megakadt
megalhatol	megalhatsz
megalunni	megaludni
megamarkoltam	megmarkoltam
megbirná	megbírná
megbocsájtja	megbocsátja
megbocsájtok	megbocsátok
megbocsájtom	megbocsátom
megbolodult	megbolondult
megbornyúzott	megborjúzott
megborzadott	megborzadt
megbosszúlni	megbosszulni
megbusul	megbúsul
megbusult	megbúsult
megbámutt	megbámult
megbírkóznia	megbirkóznia
megbírkóznom	megbirkóznom
megbírkózom	megbirkózom
megbírkózzam	megbirkózzam
megbíztatta	megbiztatta
megbútt	megbújt
megbücsüllek	megbecsüllek
megbűntetyi	megbünteti
megbűntetyik	megbüntetik
megcsinyáta	megcsinálta
megcsip	megcsíp
megcsipi	megcsípi
megcsordúl	megcsordul
megcsufoltál	megcsúfoltál
megcsípta	megcsípte
megdícsirtík	megdicsérték
megdícsírtek	megdicsértek
megdógoztunk	megdolgoztunk
megdöglöttíl	megdöglöttél
megehül	megéhül
megehült	megéhült
megehültem	megéhültem
megehültél	megéhültél
megelik	megellik
megeléglettem	megelégeltem
megelígedtek	megelégedtek
megelígedve	megelégedve
megelígelte	megelégelte
megelüőzüő	megelőző
megelüőző	megelőző
megengedöm	megengedem
megengesztelőgyik	megengesztelődik
megennyi	megenni
megeredett	megeredt
megerisztettem	megeresztettem
megeskünni	megesküdni
megesmerte	megismerte
megesmérem	megismerem
megesmérte	megismerte
megest	megint
megett	mögött
megettík	megették
megexaminálván	megegzaminálván
megfejjík	megfejjék
megfejtík	megfejték
megfele	meg
megfenyegettett	megfenyegetett
megferedett	megfürdött
megferedik	megfürdik
megfiatalogyik	megfiatalodik
megforditják	megfordítják
megforditva	megfordítva
megfordúl	megfordul
megfulladott	megfulladt
megfurják	megfúrják
megfájdú	megfájdul
megfájult	megfájdult
megfáradott	megfáradt
megfírgesűl	megférgesül
megfüsülte	megfésülte
megfüsülődjík	megfésülődjék
megfűsülködik	megfésülködik
megfűsülködött	megfésülködött
meggazdagítónk	meggazdagítunk
meggereblyeli	meggereblyézi
meggyaógyol	meggyógyul
meggyig	meddig
meggyujtani	meggyújtani
meggyujtják	meggyújtják
meggyujtotta	meggyújtotta
meggyulásából	meggyúlásából
meggyógyitja	meggyógyítja
meggyógyúlt	meggyógyult
meggyógyúltak	meggyógyultak
meggyön	megjön
meggyöttél	megjöttél
meggyúlad	meggyullad
meggyúladni	meggyulladni
meggyútják	meggyújtják
meggyútotta	meggyújtotta
meggyülni	meggyűlni
meggyütt	megjött
meggyüttem	megjöttem
meghajult	meghajolt
meghalnyi	meghalni
meghalnák	meghalnék
meghaloványodott	meghalványodott
meghals	meghalsz
megharagudt	megharagudott
megharagusznak	megharagszanak
meghibált	meghibbant
meghingerőzött	meghengergőzött
meghitta	meghívta
meghivják	meghívják
megholt	meghalt
meghí	meghív
meghíni	meghívni
meghítak	meghívtak
meghítta	meghívta
meghíttak	meghívtak
meghítták	meghívták
meghó	meghal
meghót	meghalt
meghótak	meghaltak
meghótt	meghalt
meghúzintod	meghuzintod
meghül	meghűl
meghüljön	meghűljön
megi	mögé
megigérte	megígérte
megigértem	megígértem
megigírte	megígérte
megigírtík	megígérték
megihe	mögé
megihedt	megijedt
megijedett	megijedt
megijedtíl	megijedtél
megijett	megijedt
megijjesztette	megijesztette
megin	megint
meginditott	megindított
megindíjja	megindítja
megindúl	megindul
megindúltak	megindultak
megindúnak	megindulnak
megindút	megindult
meginn	megint
meginnak	megisznak
meginnapoltuk	megünnepeltük
meginé	mögött
megiradt	megriadt
megirigyeltík	megirigyelték
megizenték	megüzenték
megjedtek	megijedtek
megjedtem	megijedtem
megjelen	megjelenik
megjelentű	megjelenésű
megjelnik	megjelenik
megjelönt	megjelent
megjelöntem	megjelentem
megjuhádzott	megjuhászodott
megjutalmazónk	megjutalmazunk
megjő	megjön
megkajita	megkapta
megkapjja	megkapja
megkedvellette	megkedvelte
megkerekitenek	megkerekítenek
megkerekitik	megkerekítik
megkerestík	megkeresték
megkeriti	megkeríti
megkerítís	megkerítés
megkezdenyi	megkezdeni
megkezdődödött	megkezdődött
megkezgyi	megkezdi
megkinálják	megkínálják
megkinálnak	megkínálnak
megkiván	megkíván
megkolbácsolják	megkorbácsolják
megkollintod	megkólintod
megkollintotta	megkólintotta
megkollintá	megkólintá
megkondúl	megkondul
megkárosítottá	megkárosítottál
megkérdözi	megkérdezi
megkérgyi	megkérdi
megkésött	megkésett
megkévánták	megkívánták
megkírdezi	megkérdezi
megkírem	megkérem
megkírik	megkérik
megkírje	megkérje
megkírni	megkérni
megkírte	megkérte
megkóstól	megkóstol
megköpüji	megköpüli
megköszőnni	megköszönni
megkötte	megkötötte
megköttem	megkötöttem
megküzsdenek	megküzdenek
megküzsdjünk	megkűzdjünk
meglepdésből	meglepődésből
meglepetésire	meglepetésére
meglátogatnyi	meglátogatni
meglüvöm	meglövöm
megmaradott	megmaradt
megmaratt	megmaradt
megmodta	megmondta
megmondanyi	megmondani
megmongya	megmondja
megmosakodjík	megmosakodjék
megmosdanni	megmosdani
megmosodni	megmosakodni
megmosztolt	megmozdult
megmozdúl	megmozdul
megmöntötted	megmentetted
megmútattak	megmutattak
megnonek	megnőnek
megnyertítek	megnyertétek
megnyilt	megnyílt
megnyirják	megnyírják
megnyugodtá	megnyugodtál
megnyugszónk	megnyugszunk
megnyuzta	megnyúzta
megnyálozta	megnyálazta
megnyált	megnyílt
megnyőjön	megnőjön
megnyőtt	megnőtt
megnyőttek	megnőttek
megnémúl	megnémul
megnéznyi	megnézni
megnëzett	megnézett
megnízem	megnézem
megnízi	megnézi
megnízik	megnézik
megnízni	megnézni
megnízte	megnézte
megnőjjön	megnőjön
megosztozkodnyi	megosztozkodni
megparancsúta	megparancsolta
megpattanik	megpattan
megpihennyi	megpihenni
megpiritanak	megpirítanak
megpiszkájják	megpiszkálják
megporoncsolta	megparancsolta
megpreczkeli	megpreckeli
megpreczkölöd	megpreckeled
megpuhitják	megpuhítják
megpürdül	megpördül
megrakta	megrakta
megreccssen	megreccsen
megriadott	megriadt
megrugja	megrúgja
megrugják	megrúgják
megrázkógyik	megrázkódik
megrémülem	megrémültem
megrőkönyödött	megrökönyödött
megsimagotja	megsimogatja
megszabadulnák	megszabadulnék
megszabadúl	megszabadul
megszabadúlni	megszabadulni
megszakadott	megszakadt
megszapodordik	megszaporodik
megszelidült	megszelídült
megszemélyesitett	megszemélyesített
megszlóal	megszólal
megszoktyík	megszokik
megszáradott	megszáradt
megszáritott	megszárított
megszáritva	megszárítva
megszégyenlette	megszégyellte
megszígyelli	megszégyelli
megszípűlt	megszépült
megszógálnám	megszolgálnám
megszólalat	megszólalt
megszólalik	megszólal
megszólitja	megszólítja
megszólitsa	megszólítsa
megszóllal	megszólal
megszóllitotta	megszólította
megszóllította	megszólította
megszünik	megszűnik
megszünjék	megszűnjék
megszünt	megszűnt
megszürik	megszűrik
megsárgú	megsárgul
megsövöm	megszövöm
megsütyi	megsüti
megsűlve	megsülve
megtanál	megtalál
megtanálja	megtalálja
megtanállom	megtalálom
megtanálnak	megtalálnak
megtanált	megtalált
megtanálta	megtalálta
megtanálták	megtalálták
megtanáltál	megtaláltál
megtanáták	megtalálták
megtelepödni	megtelepedni
megteriteni	megteríteni
megtolvasodtak	megtollasodtak
megtróbálta	megpróbálta
megtuggya	megtudja
megtutta	megtudta
megtutták	megtudták
megtészi	megteszi
megtörtínt	megtörtént
megtörtíntek	megtörténtek
megtöszöd	megteszed
megtúdni	megtudni
megtőtök	megtöltök
megtőtötték	megtöltötték
megujul	megújul
megurusolni	megorvosolni
meguóvasztyák	megolvasztják
megvagynak	megvannak
megvakúl	megvakul
megvalósitotta	megvalósította
megvattok	megvagytok
megvendígeltek	megvendégeltek
megvennyi	megvenni
megvertík	megverték
megvirradott	megvirradt
megvoncolták	megvonszolták
megváltanyi	megváltani
megvígasztalódott	megvigasztalódott
megvíradt	megvirradt
megvívik	megvív
megvót	megvolt
megvótak	megvoltak
megycsókolja	megcsókolja
megyen	megy
megyiből	megyéből
megyőnk	megyünk
megzugattyuk	megzúgatjuk
megzápolnak	megzápulnak
megában	magában
megáldanyi	megáldani
megállanyi	megállni
megállittom	megállítom
megállittám	megállítám
megállmodja	megálmodja
megállnyi	megállni
megáradott	megáradt
megát	magát
megé	mögé
megégéri	megígéri
megégérte	megígérte
megéledett	megéledt
megén	megint
megérközik	megérkezik
megérköznek	megérkeznek
megérköztek	megérkeztek
megérközém	megérkeztem
megérközött	megérkezett
megétetett	megetetett
megétetni	megetetni
megíbred	megébred
megíbredt	megébredt
megígirte	megígérte
megígézik	megigézik
megígízi	megigézi
megílhetísetek	megélhetésetek
megírintette	megérintette
megírkezett	megérkezett
megírkezik	megérkezik
megírkeznek	megérkeznek
megírkeztek	megérkeztek
megírte	megérte
megírve	megérve
megírzi	megérzi
megódta	megoldta
megörűt	megörült
megösmerkedni	megismerkedni
megösmerkedtek	megismerkedtek
megösmerte	megismerte
megúnta	megunta
megüszőgösödik	megüszkösödik
megütnyi	megütni
megütte	megütötte
megőlt	megölt
megőrizett	megőrzött
megőrzeni	megőrizni
megőrzenéd	megőriznéd
megőrzötted	megőrizted
megőrzők	megőrzök
megőrözni	megőrizni
megőtem	megöltem
megűtették	megültették
mejjére	mellére
mekor	mikor
meleben	melegben
melegenni	melegedni
melegiben	melegében
melett	mellett
melik	melyik
mellegeltetyi	meglegelteti
mellemën	mellemen
melleti	melletti
mellettek	mellettük
mellettt	mellett
mellettök	mellettük
melládd	meglásd
mellátja	meglátja
mellátogatnyi	meglátogatni
mellátta	meglátta
melléj	mellé
mellül	mellől
mellőllik	mellőlük
melyiktek	melyikőtök
men	megy
mendegílt	mendegélt
mendve	mentve
menejenek	menjenek
menek	megyek
meneküljék	meneküljön
menen	megy
menjé	menj
menjék	menjen
menkü	mennykő
mennyasszony	menyasszony
mennyasszonyával	menyasszonyával
mennyegző	menyegző
mennyenek	menjenek
mennyin	mennyien
mennyiér	mennyiért
mennyorszában	mennyországban
mennyországbúl	mennyországból
mensz	mész
mentire	menetére
mentül	mentől
mentűl	mentől
menyasszonnak	menyasszonynak
menyasszont	menyasszonyt
menyasszontáncot	menyasszonytáncot
menyasszonyval	menyasszonnyal
menyek	megyek
menyen	megy
menyire	menyére
menyit	menyét
menyjen	menjen
menynyit	mennyit
menyország	mennyország
menyországba	mennyországba
menyországban	mennyországban
mercedes-ekkel	mercedesekkel
meredett	meredt
mereő	merről
mericsd	merítsd
meritett	merített
meritték	meríték
merrek	merre
merrill-t	merrillt
merrontya	megrontja
merrázkódok	megrázkódom
merísz	merész
merűlt	merült
mesek	mesék
messzely	meszely
messzeretyi	megszereti
messzirül	messziről
messzirő	messziről
messzirűl	messziről
messzüről	messziről
mest	mester
mesterkenni	mesterkedni
mesterségivel	mesterségével
mesterségöket	mesterségüket
mesze	nesze
meszirő	messziről
mesélnyi	mesélni
meséni	mesélni
meséte	mesélte
meséték	mesélték
met	mert
metodust	metódust
mett	mert
mevvan	megvan
mezen	mezőn
mezitelen	meztelen
mezitelenül	meztelenül
mezitláb	mezítláb
mezittelen	meztelen
mezítelenűl	meztelenül
meé	miért
meégis	mégis
meét	miért
meézeset	mézeset
mibül	miből
mibűl	miből
midég	mindig
miel	mivel
mielébb	mielőbb
mielött	mielőtt
mifile	miféle
mifíle	miféle
mig	míg
mihellyest	mihelyst
mihent	mihelyt
mihentes	mihelyt
mihint	mihelyt
mihálytul	mihálytól
miirt	miért
mijatyánkot	miatyánkot
mijen	milyen
mijent	mihelyt
mijjën	milyen
mijé	miért
mikkor	mikor
miko	mikor
mikoriban	mikor
mikorira	mikorra
mikoris	mikor
mikoron	mikor
mikorára	mikorra
mikulasbirodalom	mikulásbirodalom
mikó	mikor
milimétert	milliméter
milyön	milyen
mindakettőnek	mindkettőnek
mindbül	mindből
mindeggyik	mindegyik
mindegyikbű	mindegyikből
mindek	minek
mindel	minddel
mindendenféle	mindenféle
mindenekrül	mindenekről
mindenfilekíppen	mindenféleképpen
mindenfélit	mindenfélét
mindenhö	mindenhez
mindenhő	mindenhez
mindeni	mindene
mindenik	mindegyik
mindenikbe	mindegyikbe
mindenikben	mindegyikben
mindenikből	mindegyikből
mindeniken	mindegyiken
mindeniket	mindegyiket
mindenikkel	mindegyikkel
mindeniknek	mindegyiknek
mindenikre	mindegyikre
mindeniktől	mindegyiktől
mindeniké	mindegyiké
mindenikért	mindegyikért
mindenikőtök	mindegyikőtök
mindenin	mindenén
mindenképen	mindenképpen
mindenkíppen	mindenképpen
mindenrül	mindenről
mindenrő	mindenről
mindenrű	mindenről
mindenvel	mindennel
mindenyi	mindene
mindenyit	mindenét
mindenöve	mindenüvé
mindenüt	mindenütt
mindenüve	mindenüvé
mindeé	mindegy
mindeég	mindig
mindgyárást	mindjárt
mindha	mintha
mindjár	mindjárt
mindnyájok	mindnyájuk
mindnyájokat	mindnyájukat
mindnyájon	mindnyájan
mindnyájónkot	mindnyájunkat
mindonkó	mindenkor
mindég	mindig
mindën	minden
mindënt	mindent
mindíg	mindig
mindön	minden
mindönfelé	mindenfelé
mindönfélévé	mindenfélévé
mindöntudó	mindentudó
minekutánna	minekutána
mingya	mindjárt
mingyjár	mindjárt
mingyá	mindjárt
mingyán	mindjárt
mingyár	mindjárt
ministrángyerek	ministránsgyerek
ministránsgyerekvel	ministránsgyerekkel
minjárt	mindjárt
minnyá	mindjárt
minnyátt	mindjárt
minuszban	mínuszban
minyő	minő
minékünk	minekünk
minútumba	minutumba
minőn	midőn
mirű	miről
miséznyi	misézni
mitevös	mitévő
mitevő	mitévő
mitn	mint
mitsibishi	mitsubishi
mitéveő	mitévő
mitévős	mitévő
mitévősök	mitévők
mitül	mitől
mitűl	mitől
miulta	mióta
mivéllünk	mivelünk
mizo-baranytej	mizo-baranyatej
mián	miatt
miér	miért
miét	miért
miétt	miért
mobilcom	mobilcom
mocsolyáho	mocsolyához
mohojra	moholra
mokasszin	mokaszin
mokasszinjáról	mokaszinjáról
mokasszinját	mokaszinját
mokasszint	mokaszint
molnárho	molnárhoz
mon	mondd
mond	mondd
mondanni	mondani
mondanyi	mondani
mondi	mondja
mondik	mondják
mondtá	mondta
monga	mondja
mongya	mondja
mongyam	mondjam
mongyuk	mondjuk
mongyák	mondják
mongyëk	mondja
monom	mondom
monta	mondta
montenegroban	montenegróban
montuk	mondtuk
monták	mondták
moodyí	moody's
moodyís	moody's
morgalógyik	morgolódik
morris-szal	morrisszal
morzsolástú	morzsolástól
mosatlon	mosatlan
mosdatlanúl	mosdatlanul
mosdjík	mosdjék
moshadd	moshatsz
mosnyi	mosni
mosnák	mosnék
mosodnak	mosdanak
mosogassá	mosogass
mostand	mostan
mosten	mostan
mostmá	már
mostohájok	mostohájuk
mot	most
motorvonat-tender	motorvonattender
mozditják	mozdítják
mozdulatanul	mozdulatlanul
mozdulatlanúl	mozdulatlanul
mozdítanni	mozdítani
mozdúltak	mozdultak
mozdúni	mozdulni
mozgalógyik	mozgolódik
mozsgyik	mosdik
mucskos	mocskos
mucsok	mocsok
mucsokbúl	mocsokból
muezzin	müezzin
mujjon	múljon
mujjík	múljék
mukád	munkád
mulaccságon	mulatságon
mulatgatot	mulatgatott
mulik	múlik
mulj	múlj
mulkor	múltkor
mulkór	múltkor
mulsz	múlsz
mult	múlt
multak	múltak
multkor	múltkor
mulva	múlva
munkahely-csökkentésről	munkahelycsökkentésről
munkájok	munkájuk
munkájokot	munkájukat
munkájokval	munkájukkal
munkámot	munkámat
munkánkot	munkánkat
mustoha	mostoha
mustohaanya	mostohaanya
mustohaanyja	mostohaanyja
mustohaanyjának	mostohaanyjának
mustohatestvír	mostohatestvér
mustohatestvíre	mostohatestvére
mustohatestvírit	mostohatestvérét
mustohám	mostohám
mustohátúl	mostohától
mustárraó	mustárról
muszaj	muszáj
muva	múlva
muzsikosok	muzsikusok
muzsikálnyi	muzsikálni
má	már
máccor	másszor
mácskát	macskát
mái	mai
májfiszek	madárfészek
májáját	máját
mákor	ma
málik	mállik
málva	mályva
mám	ma
mámám	ma
mán	már
márjásod	máriásod
márjásokat	máriásokat
márjást	máriást
márjával	máriával
márkabolt-hálózat	márkabolthálózat
mártony	márton
márványpalotájok	márványpalotájuk
másfelűl	másfelől
másiba	máséba
másikok	másikak
másikoknak	másikaknak
másikot	másikat
másiktúl	másiktól
másikval	másikkal
másikójokkal	másikójukkal
máskiép	másképp
máskíppen	másképpen
másoccor	másodszor
másod-kakasszókor	másodkakasszókor
másodikot	másodikat
másodpercentként	másodpercenként
másogyik	második
másoktul	másoktól
másszorra	másodszorra
mástló	mástól
másunnan	máshonnan
másvilágrúl	másvilágról
mátkájok	mátkájuk
mátkájátúl	mátkájától
máttyás	mátyás
mátáys	mátyás
mátó	mától
mé	mért
méges	mégis
mégpediglen	mégpedig
mégysz	mész
méheskasba	méhkasba
méiért	miért
mélybő	mélyből
mélyentrő	mélyről
ménesse	ménese
ménkü	mennykő
ménkű	mennykő
ménlő	ménló
mér	mért
mérgess	mérges
mérgessen	mérgesen
mérgezött	mérgezett
mérgibe	mérgébe
mérgit	mérgét
mérgössen	mérgesen
mérlegfőösszge	mérlegfőösszege
mérlegfőöszeg	mérlegfőösszeg
mértföldnyire	mérföldnyire
mérészölje	merészelje
mérőfeődre	mérőföldre
méssz	mész
mészárosho	mészároshoz
mét	mért
métt	mért
mézes-mázas	mézesmázas
mézes-mázos	mézesmázos
mëg	meg
mëgbetegszik	megbetegszik
mëgcsapott	megcsapott
mëgcsudá	megcsodál
mëgcsudájjak	megcsodáljak
mëgdöglenek	megdöglenek
mëgdöglik	megdöglik
mëgfejik	megfejik
mëghízzon	meghízzon
mëgjavul	megjavul
mëgjártó	megjárta
mëglesem	meglesem
mëgmosdik	megmosdik
mëgmosdó	megmosdasz
mëgmosnyi	megmosni
mëgmossák	megmossák
mëgmozduni	megmozdulni
mëgnëm	megnézem
mëgszipül	megszépül
mëgszületik	megszületik
mëgvágtok	megvágtok
mëgy	megy
mëgya	megy
mëgyën	megy
mëgárt	megárt
mëgént	megint
mëgëegyëselteűnk	megegyesültünk
mëgëszi	megeszi
mëgëszik	megeszik
mëhecske	méhecske
mëkkërësztelyi	megkereszteli
mëllëhet	meglehet
mën	megy
mënni	menni
mënnyek	menjek
mënt	ment
mëntem	mentem
mënteőnk	mentünk
mënyasszony	menyasszony
mënëk	megyek
mër	mer
mësszáritod	megszárítod
mëszszűrt	megszűrt
mëv	meg
mëvverik	megverik
mígy	mégy
míh	méh
míhek	méhek
míhekkel	méhekkel
mínt	mint
mínutumba	minutumba
mínutába	minutába
mír	mért
míreggel	méreggel
mírföldet	mérföldet
mírgelődött	mérgelődött
mírjík	mérjék
mírünk	mérünk
míssz	mész
mísz	mész
míveli	műveli
mívesszobában	művesszobában
míz	méz
mízeshetekenn	mézesheteken
mízesheteket	mézesheteket
mízet	mézet
mízre	mézre
mízzel	mézzel
módgyára	módjára
módulag	módúlag
mók	pók
mónár	molnár
mónárember	molnárember
mónárhoz	molnárhoz
mónárkalácsot	molnárkalácsot
mónárlegén	molnárlegény
mónárlegénnek	molnárlegénynek
mónárlegények	molnárlegények
mónárleány	molnárleány
mónárlány	molnárlány
mónárlánynak	molnárlánynak
mónárlányt	molnárlányt
mónárnak	molnárnak
mónárok	molnárok
mónárpogácsát	molnárpogácsát
mónárt	molnárt
mónártól	molnártól
mög	meg
mögadta	megadta
mögbocsájtott	megbocsájtott
mögesött	megesett
mögfagyott	megfagyott
mögfordút	megfordult
möggyógyulnak	meggyógyulnak
möghót	meghalt
mögi	mögé
mögijed	megijed
mögijedt	megijedt
mögjelenhetett	megjelenhetett
mögjelent	megjelent
mögjelönt	megjelent
mögkináta	megkínálta
mögképződött	megképződött
möglesse	meglesse
mögláti	meglátja
möglátná	meglátná
möglátta	meglátta
mögmondták	megmondták
mögnyalta	megnyalta
mögrontotta	megrontotta
mögsuprikáták	megsuprikálták
mögszógálom	megszolgálom
mögtalálni	megtalálni
mögtudta	megtudta
mögtuttak	megtudtak
mögverte	megverte
mögvigasztalhatta	megvigasztalhatta
mögöli	megöli
mögörűt	megörült
mögőte	megölte
mögőtem	megöltem
mögű	mögül
mökkora	mekkora
möktutta	megtudta
möndögelt	mendegélt
mönj	menj
mönjek	menjek
mönjenek	menjenek
mönjünk	menjünk
mönnek	mennek
mönni	menni
mönnyégből	mennyégből
mönnyél	menjél
mönnyön	menjen
mönnének	mennének
mönnöm	mennem
mönt	ment
möntek	mentek
möntünk	mentünk
mönyök	megyek
mönyön	megy
mör	mert
mörre	merre
múlat	mulat
múlatnak	mulatnak
múlatozik	mulatozik
múlattak	mulattak
múlató	mulató
múltek	múltak
múnka	munka
múnkát	munkát
mútatott	mutatott
mútatták	mutatták
múzsikaszót	muzsikaszót
mü	mi
münköt	minket
müvész	művész
mő	mert
mőné	minél
mőre	merre
műanyagcső-gyártók	műanyagcsőgyártók
műemlék-együttes	műemlékegyüttes
műszál-alapanyagok	műszálalapanyagok
nadír	nadir
nagodájából	pagodájából
nagoyn	nagyon
nagy-brittaniában	nagy-britanniában
nagy-pénteken	nagypénteken
nagyanyámtul	nagyanyámtól
nagyapámtú	nagyapámtól
nagyasszonnya	nagyasszonya
nagyhetibe	nagyhetébe
nagyhőncölt	nagygöncölt
nagyott	nagyot
nagypinteken	nagypénteken
nagypintëkën	nagypénteken
nagyravagyo	nagyravágyó
nagysagos	nagyságos
nagyszöllősi	nagyszőlősi
nagyszöllősinek	nagyszőlősinek
nagysám	nagyságám
nagytkarításhoz	nagytakarításhoz
nagyöregapámtul	nagyöregapámtól
nanyám	nyanyám
napallá	nappallá
napbúl	napból
napelem-cella	napelemcella
napföljötte	napfeljötte
napfölkelte	napfelkelte
napfölkeltre	napfelkeltére
napkeltétül	napkeltétől
napkélte	napkelte
napkölte	napkelte
napnyugoti	napnyugati
naposholdas	napos-holdas
napszálat	napszállat
naptyába	napjában
naptyán	napján
naptúl	naptól
ne-ne	ne
neezték	nézték
negyed-kakasszókor	negyedkakasszókor
negyegyik	negyedik
nehez	nehéz
nehezenn	nehezen
nehezitett	nehezített
nehán	néhány
nehány	néhány
nehíz	nehéz
nekidül	nekidől
nekie	neki
nekiek	nekik
nekiharagudt	nekiharagudott
nekije	neki
nekirikótott	nekirikoltott
nekiuszittám	nekiuszítám
nekëd	neked
nekëm	nekem
neköd	neked
neköm	nekem
nekőnk	nekünk
nemhíába	nemhiába
nemjófélivel	nemjófélével
nemzeközi	nemzetközi
nemzetségbő	nemzetségből
nemzetséginek	nemzetségének
nemzsetes	nemzetes
nemösnek	nemesnek
nep	nép
nepmese	népmese
nepmesek	népmesék
netlock-ot	netlockot
nevellő	nevelő
nevelőjim	nevelőim
nevelőnni	nevelődni
neven	néven
nevendék	növendék
nevesztem	neveztem
neveszték	nevezték
nevetött	nevetett
nevi	neve
nevibe	nevébe
nevire	nevére
nevit	nevét
nevé	neve
nevëvel	nevével
nevök	nevük
nezdegelt	nézdegélt
nezek	nézek
nezett	nézett
nezi	nézi
neznek	néznek
neézzék	nézzék
neézëtt	nézett
nikenak	nike-nak
nintendonak	nintendónak
nipekhöz	népekhez
niégy	négy
niézőknek	nézőknek
nna	na
nobel-től	nobeltől
nocsik	nocsak
nohát	hát
noteccit	noteszét
noteszgép-piac	noteszgéppiac
novatris	novartis
novembertül	novembertől
nyakadbó	nyakadból
nyakadot	nyakadat
nyakábó	nyakából
nyakáró	nyakáról
nyavaja	nyavalya
nyavajája	nyavalyája
nyavalyatörös	nyavalyatörős
nye	ne
nyeldeklőji	nyeldeklője
nyelibe	nyelébe
nyeliebe	nyelébe
nyelin	nyelén
nyelit	nyelét
nyelivel	nyelével
nyellel	nyelvvel
nyelvit	nyelvét
nyelvivel	nyelvével
nyelvön	nyelven
nyergyuk	nyerjük
nyergyük	nyerjük
nyersgyémánt-termelés	nyersgyémánttermelés
nyersolaj-átlagárat	nyersolajátlagárat
nyerségből	nyereségből
nyerte-ütésre	nyerteütésre
nyervákolt	nyervákol
nyeőjjék	nőjön
nyilatakozott	nyilatkozott
nyilik	nyílik
nyilt	nyílt
nyilva	nyílva
nyilval	nyíllal
nyilásra	nyílásra
nyilást	nyílást
nyilásán	nyílásán
nyilását	nyílását
nyiló	nyíló
nyitaná	nyitná
nyitik	nyitják
nyitta	nyitotta
nyitta-csukta	nyitotta-csukta
nyomoruságba	nyomorúságba
nyomorúlt	nyomorult
nyomorút	nyomorult
nyoszolyoleányok	nyoszolyóleányok
nyoszoló	nyoszolyó
nyudogni	nyugodni
nyugatanúl	nyugtalanul
nyughassá	nyughass
nyugodnyi	nyugodni
nyugoszik	nyugszik
nyugosznak	nyugszanak
nyugot	nyugat
nyugotnak	nyugatnak
nyugotra	nyugatra
nyugunni	nyugodni
nyugusznak	nyugszanak
nyugvási	nyugvása
nyujtja	nyújtja
nyujtott	nyújtott
nyujtotta	nyújtotta
nyujtófát	nyújtófát
nyujtófával	nyújtófával
nyukszik	nyugszik
nyul	nyúl
nyulfarkányit	nyúlfarknyit
nyulj	nyúlj
nyuljanak	nyúljanak
nyultak	nyúltak
nyuzza	nyúzza
nyákás	nyálkás
nyársot	nyársat
nyássra	nyársra
nyávot	nyávog
nyílját	nyilát
nyíltanak	nyíltak
nyílásho	nyíláshoz
nyílászáró-cserék	nyílászárócserék
nyíratkozik	nyiratkozik
nyóc	nyolc
nyócszáz	nyolcszáz
nyócvan	nyolcvan
nyócvankilenc	nyolcvankilenc
nyócökrös	nyolcökrös
nyócökröshön	nyolcökröshöz
nyött	nőtt
nyövet	növet
nyú	nyúlj
nyúlak	nyulak
nyúlam-búlam	nyulam-bulam
nyúlat	nyulat
nyúlom-búlom	nyolam-bulam
nyúlott	nyúlt
nyúlottak	nyúltak
nyútotta	nyújtotta
nyútva	nyújtva
nyútódzkodott	nyújtózkodott
nyútófátó	nyújtófától
nyútózkodott	nyújtózkodott
nyügöt	nyűgöt
nyő	nő
nyőjön	nőjön
nyől	nő
nyőlt	nőtt
nyőstént	nőstényt
nyőtt	nőtt
nyőttem	nőttem
nádasbul	nádasból
nálla	nála
nállam	nálam
nállunk	nálunk
nálok	náluk
nálónk	nálunk
nászasszonyáhó	nászasszonyához
nászéccakán	nászéjszakán
néd	nézd
négy-szívű	négyszívű
néhányót	néhányat
néked	neked
nékem	nekem
néki	neki
nékiek	nekik
nékik	nekik
néköd	neked
néköm	nekem
nékül	nélkül
nékült	nélkül
nékünk	nekünk
nékű	nélkül
nélkűl	nélkül
nénji	nénje
népekvel	népekkel
népinek	népének
népivel	népével
népök	népek
nésztük	néztük
név-viselője	névviselője
nézegetyi	nézegeti
nézegetésébő1	nézegetéséből
nézelodött	nézelődött
néznyi	nézni
nézzetök	nézzetek
nézésiben	nézésében
në	ne
nëm	nem
nëma	néma
nëzni	nézni
nëzzen	nézzen
nígy	négy
nígyen	négeyn
nígyet	négyet
nígyfelé	négyfelé
níp	nép
nípe	népe
nípek	népek
nípeket	népeket
níppel	néppel
níz	néz
nízd	nézd
nízegette	nézegette
nízek	nézek
nízett	nézett
nízi	nézi
nízik	nézik
nízni	nézni
níznyi	nézni
nízte	nézte
nízz	nézz
nízze	nézze
nízzed	nézd
nízzík	nézzék
nízzítek	nézzétek
nízzük	nézzük
nízzünk	nézzünk
nízísirűl	nézéséről
nízők	nézők
nó	no
nö	nő
nöjjön	nőjön
növeléni	növelni
növényegészségügyi	növény-egészségügyi
növényekrül	növényekről
nözögesd	nézegesd
nőjjenek	nőjenek
nőjjön	nőjön
nősülnyi	nősülni
nőttel	nőttek
nővéremné	nővéremnél
nővériné	nővérénél
nővérit	nővérét
nővéritő	nővérétől
oan	olyan
od'adja	odaadja
od'adta	odaadta
odaatta	odaadta
odabe	odabenn
odabé	odabenn
odadjuk	odaadjuk
odadni	odaadni
odadott	odaadott
odadta	odaadta
odadtam	odaadtam
odafel	odafenn
odafogont	odafogant
odagyugott	odadugott
odagyött	odajött
odagyün	odajön
odahajút	odahajolt
odahítta	odahívta
odaigírte	odaígérte
odajönek	odajönnek
odakajált	odakiált
odakerűlt	odakerült
odakisérik	odakísérik
odakiátottak	odakiáltottak
odakötte	odakötötte
odakötőzi	odakötözi
odakünt	odakint
odalíp	odalép
odalípett	odalépett
odamenyek	odamegyek
odamenyen	odamegy
odamönt	odament
odanyújtatta	odanyújtotta
odanízett	odanézett
odaníztünk	odanéztünk
odaparancsúta	odaparancsolta
odasetétedjünk	odasötétedjünk
odaszaladott	odaszaladt
odattam	odaadtam
odatötte	odatette
odaveszött	odavaszett
odavezetyi	odavezeti
odavágtatot	odavágtatott
odavót	odavolt
odavótatok	odavoltatok
odaérközik	odeérkezik
odaérköztek	odaérkeztek
odaígírte	odaígérte
odaírkezett	odaérkezett
odaírt	odaért
odaüttem	odaütöttem
odd	add
odhajol	odahajol
oduban	odúban
ohati	óvhatja
ojan	olyan
ojjan	olyan
oket	őket
olaiprai	olajipari
olajkitemelés	olajkitermelés
olajkitermelési	olaj-kitermelési
olan	olyan
olból	ólból
oldalrúl	oldalról
ollan	olyan
olly	oly
ollyan	olyan
ollyant	olyat
ollyat	olyat
oltárhó	oltárhoz
oltóanyagtermelő	oltóanyag-termelő
oltón	olton
olvasnyi	olvasni
olvassnak	olvasnak
olvassëk	olvasson
olyam	olyan
olyanoktul	olyanoktól
oláhokval	oláhokkal
oncse	öntse
onnat	onnan
operencián	óperencián
operenczián	óperencián
opsitos	obsitos
opsitosnak	obsitosnak
ora	óra
orbáncznak	orbáncnak
orcámrúl	orcámról
orcátlan	arcátlan
ordináncot	ordonáncot
ordit	ordít
orditja	ordítja
orralikából	orrlyukából
orralikán	orrlyukán
orralikával	orrlyukával
orralukán	orrlyukán
orrik	orruk
orrikból	orrukbúl
orrlikán	orrlyukán
orrlukra	orrlyukra
orrozta	orozta
orrábúl	orrából
orsajának	orsójának
orsajáról	orsójáról
orsaját	orsóját
országbó	országból
országbúl	országból
országombó	országomból
országomot	országomat
országonn	országon
országotvilágot	országot-világot
országszilre	országszélre
országszíl	országszél
országszílbe	országszélbe
országszílben	országszélben
országuton	országúton
országvilág	ország-világ
országábó	országából
országábúl	országából
országúni	országolni
orsójaér	orsójáért
orvasság	orvosság
orvasságot	orvosságot
orvast	orvost
orvosónyi	orvosolni
ossóját	orsóját
osztakoznak	osztozkodnak
osztan	aztán
oszten	aztán
osztág	aztán
osztán	aztán
osztég	aztán
osztén	aztán
oszágunkban	országunkban
otten	ott
otteé	ott
otthatta	otthagyta
otthattak	otthagytak
otthatták	otthagyták
otthonró	otthonról
otthonrúl	otthonról
otthonrút	otthonról
otthun	otthon
otté	ott
ouola	ólja
ozsonna	uzsonna
ozsonnakor	uzsonnakor
ozt	azt
oztán	aztán
oíleary	o'leary
oóllt	ollót
oóllval	ollóval
oú	ó
padlaja	padlója
pagácsaforma	pogácsaforma
pajika	palika
pajtáho	pajtához
palinkát	pálinkát
pallásho	padláshoz
pallásra	padlásra
pallásrúl	padlásról
pallásán	padlásán
palotábló	palotából
palotábúl	palotából
palotáho	palotához
palotájaig	palotájáig
palotájja	palotája
palotájjába	palotájába
palotájjához	palotájához
palotájokra	palotájukra
palotátúl	palotától
panaszkogyik	panaszkodik
panaszkotta	panaszkodta
panaszolnyi	panaszolni
pandúrokot	pandúrokat
paneészbogarat	penészbogár
paolin-xi	pao-lin-xi
papho	paphoz
paphó	paphoz
papirba	papírba
papirra	papírra
papirral	papírral
papirszeleteket	papírszeleteket
papirszeletre	papírszeletre
papirt	papírt
papuk	papjuk
papírosba	papirosba
papírosból	papirosból
papírosra	papirosra
papírossal	papirossal
papírost	papirost
paracsolta	parancsolta
parancsojon	parancsoljon
parancsolnyi	parancsolni
parancsósz	parancsolsz
parancsóta	parancsolta
parancsóták	parancsolták
parancsúni	parancsolni
parokján	parókián
parokjára	parókiára
parokját	parókiát
parázst	parazsat
parázstul	parázstól
pasztorlany	pásztorlány
pataka	patakja
patakho	patakhoz
patakró	patakról
patakában	patakjában
patakáig	patakjáig
patente	patentet
patikábúl	patikából
patkójok	patkójuk
patokót	patkót
pattján	partján
pegy	pedig
pegyig	pedig
pegyiglen	pediglen
pejig	pedig
pekaonál	pekaónál
pelleni	elleni
pendellér	pendelyért
pendelyibe	pendelyébe
pereteő	perctől
perzekútor	perzekutor
perzekútorok	perzekutorok
perzekútorokat	perzekutorokat
perzekútorokhoz	perzekutorokhoz
perzekútoroknak	perzekutoroknak
petyár	betyár
peugeot-citroen	peugeot-citroën
picziny	piciny
pihennyi	pihenni
pillanattó	pillanattól
pinczébe	pincébe
pinczéből	pincéből
pincéjökben	pincéjükben
pinteken	pénteken
pintëkënn	pénteken
pinz	pénz
pirimókoson	pirimókosan
piritott	pirított
piritós	pirítós
pirossat	pirosat
piszkafávó	piszkafával
piszkaâgasd	piszkálgasd
piszkányi	piszkálni
pisállni	pisálni
pitarajtaón	pitvarajtón
pitvarajto	pitvarajtó
pitymalott	pitymallott
piénteken	pénteken
piénteket	pénteket
piénzt	pénzt
plebánia	plébánia
pletykós	pletykás
plé	pléh
pofokot	pofonokat
poforit	pofont
pohárbúl	pohárból
pojákországból	polyákországból
pokolküvem	pokolkövem
pokrócczal	pokróccal
politikárú	politikáról
pontossan	poontosan
ponyolát	pongyolát
porciaós	porciós
porciaóst	porcióst
poreé	porrá
poroncsig	parancsig
poroncsol	parancsol
poroncsolj	parancsolj
poroncsolja	parancsolja
poroncsolod	parancsolod
poroncsolok	parancsolok
poroncsolom	parancsolom
poroncsolsz	parancsolsz
poroncsolt	parancsolt
poroncsra	parancsra
poroncsát	parancsát
portfolio	portfólió
portfolió-befektetések	portfólióbefektetések
portfolióban	portfólióban
portfoliójának	portfóliójának
portfoliót	portfóliót
portáró	portáról
portékájokat	portékájukat
poróbálom	próbálom
pozdorja-garmadán	pozdorjagarmadán
practicat	praktikát
practicával	praktikával
presztízs-nyereségre	presztízsnyereségre
pricewaterhousecooper	pricewaterhousecoopers
pricsnyerget	priccsnyerget
privatiációja	privatizációja
profit-esés	profitesés
profitjánakk	profitjának
proscribaltassék	proskribáltassék
proscribáltassék	proskribáltassék
prosiebensat1	prosiebensat.1
prédikálnyi	prédiálni
próbákot	próbákat
próbákoznak	próbálkoznak
próbálnyi	próbálni
próbáni	próbálni
prücsök-ember	prücsökember
puczoválja	pucoválja
pucérre	pucérra
pucëron	pucéron
puhár	pohár
pujám	pulyám
puját	pulyát
pulicka	puliszka
pulickát	puliszkát
pulykájok	pulykájuk
pulykájoknak	pulykájuknak
purdi	purdé
puskámot	puskámat
puskámval	puskámmal
pusokval	pusokkal
pusztitsák	pusztítsák
pusztullok	pusztulok
pusztíjjam	pusztítsam
pusztítanni	pusztítani
pusztítassa	pusztíttassa
put	fut
pá1	pál
pácákat	pálcákat
pácával	pálcával
pádimentom	pádimentum
pájinka	pálinka
pályinka	pálinka
pályinkabaó	pálinkából
pályinkát	pálinkát
pályázhatik	pályázhat
pánczélba	páncélba
pászolt	passzolt
pásztor-ember	pásztorember
pászította	passzította
pénszt	pénzt
péntëkën	pénteken
pénzbő	pénzből
pénzgyüjtésen	pénzgyűjtésen
pénzi	pénze
pénzibő	pénzéből
pénziből	pénzéből
pénzik	pénzük
pénzit	pénzét
pénzkezelő-pénzgyüjtő	pénzkezelő-pénzgyűjtő
pénzmosás-ellenes	pénzmosásellenes
pénzrő	pénzről
pénzé	pénze
pénzér	pénzért
pénzödet	pénzedet
pénzök	pénzük
pénzőnk	pénzünk
péter	péter
péterül	pétertől
pétör	péter
péz	pénz
pëndeli	pendely
pëndëli	pendely
pënz	pénz
pënzt	pénzt
pínze	pénze
pínzen	pénzen
pínzt	pénzt
pínzzel	pénzzel
pípár	pipát
pípát	pipát
pípék	pipék
píros	piros
píz	pénz
pízt	pénzt
pócokon	polcokon
pócon	polcon
pógár	polgár
pógárember	polgárember
pókhálaó	pókháló
pöffeszkegyik	pöffeszkedik
pöknyi	pökni
pöndöly	pendely
pöndölyhálójába	pendelyhálójába
pöndölyöstül	pendelyestül
pöngetni	pengetni
pörgetnyi	pörgetni
pörzsülik	perzselik
pöről	pöröl
púrgatóriúmból	purgatóriumból
pükni	pökni
püskösd	pünkösd
rablókval	rablókkal
rabóta	rabolta
rajram	rajtam
rajtad	rajtad
rajtik	rajtuk
rajtok	rajtuk
rajtónk	rajtunk
rajtúk	rajtuk
raknyi	rakni
rakoggyanak	rakodjanak
rakonni	rakodni
ravatalozójáho	ravatalozójához
raóka	róka
rea	rá
reaakad	ráakad
reaakadtam	ráakadtam
reafogta	ráfogta
reafogták	ráfogták
reagondolom	rágondolom
reahúzták	ráhúzták
realő	rálő
realőnek	rálőnek
reanult	renault
reapattintsa	rápattintsa
reasójtottam	rásújtottam
reatalált	rátalált
reataláltak	rátaláltak
reavertek	rávertek
reaállottak	ráálltak
receptét	receptjét
regelijéből	reggelijéből
regement	regiment
regementjét	regimentjét
regge	reggel
regge're	reggelre
regióban	régióban
rejtötte	rejtette
rejtözködve	rejtőzködve
reklámfelügyeleti	reklám-felügyeleti
reménylette	remélte
reménységit	reménységét
rendelkezhetik	rendelkezhet
rendeltett	rendeltetett
rendessen	rendesen
rendeszték	rendezték
rendibe	rendjében
rendjin	rendjén
rendkivül	rendkívül
rendkivüli	rendkívüli
rendësen	rendesen
rendölt	rendelt
rendölve	rendelve
rendös	rendes
rendösön	rendesen
repitteni	repíteni
repótenderen	repotenderen
repöstölt	repestelt
repűl	repül
repűljetek	repüljetek
repűlnek	repülnek
repűlve	repülve
reuters-re	reutersre
rezsedencia	rezidencia
rezsedenciába	rezidenciába
rezsedenciához	rezidenciához
rezsedenciájába	rezidenciájába
rezsedenciáját	rezidenciáját
rezsketett	reszketett
reád	rád
reágondolom	rágondolom
reágondolt	rágondolt
reáhajtsa	ráhajtsa
reájok	rájuk
reákiált	rákiált
reákiáltott	rákiáltott
reálép	rálép
reánk	ránk
reányitja	rányitja
reánézett	ránézett
reáparancsol	ráparancsol
reápillantott	rápillantott
reárántottak	rárántottak
reásuhintott	rásuhintott
reászoktatták	rászoktatták
reászállott	rászállt
reásújtottam	rásújtottam
reátalált	rátalált
reátok	rátok
reávethesse	rávethesse
reávette	rávette
reáülhessen	ráülhessen
rikhárdro	richárdra
rikit	rikít
rimánykodni	rimánkodni
ringyesrongyos	ringyes-rongyos
ritten	réten
rivalt	rivallt
rivást	rívást
riéten	réten
riétest	rétest
rokonja	rokona
rompress	rompres
roncsák	rontsák
rontik	rontják
rontó-asszonyok	rontóasszonyok
roskadásik	roskadásig
rossman	rossmann
rossmannak	rossmann-nak
rosszt	rosszat
rosszval	rosszal
rosszúl	rosszul
rosz	rossz
roszabbul	rosszabbul
rothadní	rothadni
rozmaringszá	rozmaringszál
rozmarint	rozmaring
rozmarintot	rozmaringot
rozmarintszál	rozmaringszál
rozmarintszálat	rozmaringszálat
rozmarinttal	rozmaringgal
rt-ben	rt.-ben
rt-nek	rt.-nek
rt-nél	rt.-nél
rt-re	rt.-re
rt-t	rt.-t
rudra	rúdra
rug	rúg
rugdosi	rugdossa
rugni	rúgni
rugonfali	rugonfalvi
rugásra	rúgásra
ruháikbúl	ruháikból
ruhájok	ruhájuk
ruhájokat	ruhájukat
ruhájáró	ruhájáról
ruhákot	ruhákat
ruhávó	ruhával
ruháér	ruháért
rula	róla
rá	rá
ráannyi	ráadni
rábaó	rába
rábeszílte	rábeszélte
rábirta	rábírta
rábolintott	rábólintott
rácsudálni	rácsodálni
rádás	ráadás
ráeseledett	ráesteledett
ráfekütt	ráfeküdt
rágnyi	rágni
rágondóta	rágondolta
ráhajintotta	ráhajította
ráhintyik	ráhintik
ráirták	ráírták
ráirva	ráírva
rájavetette	rávetette
rájok	rájuk
rákajáltott	rákiáltott
ráköttek	rákötöttek
rálíp	rálép
rálípett	rálépett
rálíptek	ráléptek
rálűtt	rálőtt
rámútat	rámutat
rámútatni	rámutatni
ránczából	ráncából
ráneéz	ránéz
ránéznyi	ránézni
ránézök	ránézek
ránézött	ránézett
ránëz	ránéz
rászóna	rászólna
rátanálnak	rátalálnak
rátanálok	rátalálok
rátanáltam	rátaláltam
ráteriti	ráteríti
rátok	rátok
rátottában	rántottában
rázzá	rázza
ráállani	ráállni
ráúnt	ráunt
ráűnek	ráülnek
rége	régen
régesrégen	réges-régen
régge	reggel
régön	régen
régúta	régóta
réjik	rájuk
rémiti	rémíti
rémitő	rémítő
rémsígeket	rémségeket
részedése	részesedése
részesdése	részesedése
részesedét	részesedést
részibe	részébe
részin	részén
részit	részét
részivel	részével
réta	rajta
rétad	rajtad
rétam	rajtam
rézszürűmön	rézszérűmön
réztányír	réztányér
rëgge	reggel
rëggelinkint	reggelenként
rëgvel	reggel
rígen	régen
rígi	régi
ríhes	rühes
ríjj	ríj
rínya	rína
rínyi	ríni
ríszesítettík	részesíttetik
ríszibe	részébe
ríszire	részére
rít	rét
ríten	réten
rítes	rétes
rítest	rétes
rítre	rétre
rójja	rója
róka-kisasszony	rókakisasszony
róka-kisasszonyt	rókakisasszonyt
rókábúl	rókából
róle	róla
rólla	róla
róllam	rólam
róssz	rossz
rózsafűzért	rózsafüzért
rózsató	rózsatő
rózsákot	rózsákat
rózsás-fehér	rózsásfehér
rögge	reggel
röggel	reggel
röggelre	reggelre
röggere	reggelre
röndezik	rendezik
röndölje	rendelje
röndölközése	rendelkezése
röndös	rendes
röndösebbje	rendesebbje
röndözik	rendezik
röpittem	röpítem
röpked	repked
röpkedett	repkedett
röst	rest
röstelkedett	röstellkedett
röstelt	röstellt
rövdihír	rövidhír
rúgdosom	rugdosom
rúhába	ruhába
rúhával	ruhával
rúla	róla
rúlla	róla
rútok	róluk
safeway-nek	safewaynek
salesainer	salesianer
salugáteron	zsalugáteren
samsug	samsung
samsung-nak	samsungnak
sanofi-aventis	sanofi-aventis
sanofi-synthelabo	sanofi-sythélabo
sarkantyus	sarkantyús
sarkvasára	sarokvasára
sarkáná	sarkánál
sarogjába	saroglyába
saru-varga	saruvarga
saru-vargának	saruvargának
sasho	sashoz
satyanarayanara	satyanarayanára
satöbi	satöbbi
saózáskor	sózáskor
saózótekneőbe	sózóteknőbe
sebess	sebes
sebjeit	sebeit
seböket	sebüket
sebös	sebes
sebössen	sebesen
seggibe	seggébe
seginsig	szegénység
segit	segít
segits	segíts
segitteni	segíteni
segittsen	segítsen
segétek	segítek
segíjjen	segéljetek
segíjjetek	segéljetek
segíljek	segéljek
segíljen	segéljen
segítenni	segíteni
segítenyi	segíteni
segítetttél	segítettél
segítteni	segíteni
segítöttek	segítettek
sehun	sehol
sejem	selyem
sejtötte	sejtette
selyemrít	selyemrét
selyemríten	selyemréten
selyemrítre	selyemrétre
semem	szemem
semmiféleképen	semmiféleképpen
semmihő	semmihez
semmijik	seemmijük
semmijük	semmijük
semmikép	semmiképp
semmiképen	semmiképpen
semmikíppen	semmiképpen
semmisigbe	semmiségbe
semmisígbe	semmiségbe
semmitül	semmitől
seni	senki
senkihe	senkihez
senkijök-semmijök	senkjük-semmijük
sentelje	szentelje
sepregetëssel	sepregetéssel
sepregëtésrül	sepregetésről
seprett	sepert
seprüt	seprűt
seprőnyél	seprűnyél
seprőnyélbe	seprűnyélbe
seregiből	seregéből
seregjenek-forogjonak	seregjenek-forogjanak
sernyësen	serényen
serégével	seregével
serénye	sörénye
setét	sötét
setétbe	sötétbe
setétben	sötétben
setétedett	sötétedett
setétedéskor	sötétedéskor
setétség	sötétség
setétségbe	sötétségbe
setétségben	sötétségben
setétülni	sötétülni
shanghajban	sanghajban
siemens-nél	siemensnél
siemes	siemens
siettség	sietség
siettében	sietség
sifonbúl	sifonból
sik	sík
sikerűlt	sikerült
simongatja	simogatja
simongatnod	simogatod
simongatta	simogatta
sinfölik	sinfelik
singnyére	singnyire
sinylő	sínylő
sinylőbe	sínylőbe
sipogjatok	csipogjatok
sipogta	csipogta
sipolásra	sípolásra
sirba	sírba
sirbak	silbak
sirban	sírban
sirból	sírból
sirdogált	sírdogált
sirjon	sírjon
sirnak	sírnak
sirni	sírni
siromban	síromban
sirról	sírról
sirt	sírt
sirtál	sírtál
sirás	sírás
sirást	sírást
sirását	sírását
siró	síró
siskárul	siskáról
sivalkogyik	sivalkodik
sivit	sivít
skatulya-koporsóba	skatulyakoporsóba
slovftnál	slovnaftnál
sohajtva	sóhajtva
sohat	sokat
sohse	sose
sohugy	sehogy
sohunn	sehol
sohuva	sehová
sok	sok
sokaságu	sokaságú
sokval	sokkal
sokág	sokáig
sokállotta	sokallta
somongatta	simogatta
soram	sorom
sorkammal	sarkammal
sorányonnak	soványodnak
soványok	soványak
squibbel	squibb-bel
stolából	stólából
sugorodtanak	zsugorodtak
suhogásátúl	suhogásától
suhutt	sehol
suhuva	sehova
sujtja	sújtja
sulyos	súlyos
sumval	svunggal
sungban	svungban
sunkát	sonkát
supp	zsupp
supp-supp	zsupp-zsupp
suppant	zsuppant
sustákja	suszták
suttogásikból	suttogásukból
suttyomba	suttyomban
symantec-nek	symantecnek
szabadulnyi	szabadulni
szabadúl	szabadul
szabadúlhatnak	szabadulhatnak
szabadúlhatunk	szabadulhatunk
szabadúlnak	szabadulnak
szabatkára	szabadkára
szabolcsban	szabolcsban
szabómná	szabómnál
szabóná	szabónál
szadságon	szabadságon
szagulja	szagolja
szagátam	szolgáltam
szakatt	szakadt
szakattam	szakadtam
szakintani	szakítani
szakitani	szakítani
szakitsa	szakítsa
szakácsnémval	szakácsnémmal
szakácsník	szakácsnék
szakállos	szakállas
szakídd	szakítsd
szalanni	szaladni
szalatt	szaladt
szalmábó	szalmából
szalonasütés	szalonnasütés
szalonnaé	szalonnáért
szalonnábúl	szalonnából
szamosujvár	szamosújvár
szamárbőrből	szamárbőrből
szamárho	szamárhoz
szamárkoró	szamárkóró
szamárval	szamárral
szaporogyik	szaporodik
szaporítonak	szaporítanak
szarajevo	szarajevó
szarvarmarhákat	szarvasmarhákat
szarvas-marháját	szarvasmarháját
szarvas-marhát	szarvasmarhát
szarvasmarha-fajtákat	szarvasmarhafajtákat
szarvu	szarvú
szarváva	szarvával
szavakval	szavakkal
szavamot	szavamat
szavok	szavuk
szaó	szó
szaóllyak	szóljak
sze	hiszen
szedel	szedsz
szednyi	szedni
szegeletin	szegletén
szegeletire	szegletére
szegeletjében	szegletében
szegeletre	szegletre
szegeőttem	szegődtem
szeghalomon	szeghalmon
szegibe	szegébe
szegin	szegény
szegletinek	szegletének
szegletjét	szegletét
szegén	szegény
szegénnek	szegénynek
szegénységöt	szegénységet
szegínnek	szegénynek
szegíny	szegény
szegínyek	szegények
szejjelvetette	széjjelvetette
szeker	szekér
szekerbe	szekérbe
szekeren	szekéren
szekerit	szekerét
szekreket	szekereket
szekértül	szekértől
szekírre	szekérre
szekírrel	szekérrel
szelemökke	szellemekkel
szelidített	szelídített
szelidült	szelídült
szelit	szelét
szelkakas	szélkakas
szellemökke	szellemekkel
szembelűtt	szembelőtt
szemekvel	szemekkel
szemenkint	szemenként
szemeszája	szeme-szája
szemetrakásra	szemétrakásra
szemfödőre	szemfedőre
szemfödőt	szemfedőt
szemi	szeme
szemi-szája	szeme-szája
szemibe	szemébe
szemibő	szeméből
szemibűl	szeméből
szemik	szemük
szemiket	szemüket
szeminek	szemének
szemire	szemére
szemirűl	szeméről
szemit	szemét
szemlélödésed	szemlélődésed
szemme	szemmel
szemverében	szemverésben
szemétszáját	szemét-száját
szemët	szemét
szemök	szemük
szemöket	szemüket
szemöket-szájokat	szemüket-szájukat
szemöknek	szemüknek
szemőcs	szemölcs
szemődöke	szemöldöke
szeműnköt	szemünket
szendvicspanel-gyártó	szendvicspanelgyártó
szennyi	szelni
szennyvíz-kibocsátást	szennyvízkibocsátást
szentöl	szentel
szentöltvizet	szenteltvizet
szentöltvíz	szenteltvíz
szentü't	szentelt
szentült	szentelt
szentünyi	szentelni
szentűtesse	szenteltesse
szenvedjé	szenvedj
szerbiában	szerbiában
szerecseny	szerecsen
szerecsenyország	szerecsenország
szerecsenyországba	szerecsenországba
szerelemes	szerelmes
szerelmös	szerelmes
szerelöm	szerelem
szerencse-tündér	szerencsetündér
szerencséji	szerencséje
szerencséjik	szerencséjük
szerencsétlenségibe	szerencsétlenségébe
szerencsíd	szerencséd
szerencsíje	szerencséje
szerencsíjek	szerencséjük
szerencsíre	szerencsére
szerencsís	szerencsés
szerencsít	szerencsét
szerencsítek	szerencsétek
szeretedet	szereteted
szeretejitől	szeretőjétől
szeretejének	szeretőjének
szereteőmhö	szeretőmhöz
szerettë	szerette
szeretyi	szereti
szeretőji	szeretője
szeretőjit	szeretőjét
szeretőjivel	szeretőjével
szeri-száma	szere-száma
szerit-módját	szerét-módját
szerit-számát	szerét-számát
szerlmes	szerelmes
szernvel	szemmel
szerszámokot	szerszámokat
szervétát	szalvéta
szervízszolgáltatásokról	szervizszolgáltatásokról
szerént	szerint
szerétenszéjjel	szerteszéjjel
szetgény	szegény
szeíek	szelek
szigetiné	szigetinél
szigetiékné	szigetiéknél
szigetjén	szigetén
szigetjére	szigetére
szigoruan	szigorúan
szijjas	szíjas
szijjel	széjjel
sziját	szíját
szilvapájinkába	szilvapálinkába
szilvapájinkát	szilvapálinkát
szilvásónkba	szilvásunkba
szinaranynyal	színarannyal
szine	színe
szined	színed
szineit	színeit
szinekben	színekben
szinire	színére
szinre	színre
szintë	szinte
szinárnyalatra	színárnyalatra
szinén	színén
szinére	színére
szinét	színét
szinültig	színültig
szinű	színű
szittyaországába	szittyaországban
szittyaországában	szittyaországban
szittyaországából	szittyaországból
szitálnyi	szitálni
szivből	szívből
szive	szíve
sziveden	szíveden
szivedet	szívedet
sziveket	szíveket
szivelhette	szívelhette
szivem	szívem
szivemből	szívemből
szivemet	szívemet
szives	szíves
szivesen	szívesen
szivességit	szívességét
szivet	szívet
szivja	szívja
szivta	szívta
szivëre	szívére
szivóbúl	szívóból
szivükhöz	szívükhöz
sziéliere	szélére
szlójanak	szóljanak
szlóni	szólni
szlóott	szólott
szlótam	szóltam
szlótál	szóltál
szlóítani	szólítani
szlóítsam	szólítsam
szobábúl	szobából
szobájuktúl	szobájuktól
szobárúl	szobáról
szoftver-céggel	szoftvercéggel
szoftver-központot	szoftverközpontot
szoftver-értékesítésből	szoftverértékesítésből
szogánok	szolgának
szolgálatjukra	szolgálatukra
szolgálatjára	szolgálatára
szolgálatját	szolgálatát
szolgállónak	szolgálónak
szolgálnyi	szolgálni
szolgálójánnak	szolgálójának
szolgálójánnya	szolgálólánya
szolgálójány	szolgálólány
szomorit	szomorít
szomoruan	szomorúan
szomorán	szomorúan
szomorúvan	szomorúan
szomsziéd	szomszéd
szomszédasszont	szomszédasszonyt
szomszédbú	szomszédból
szomszédbúl	szomszédból
szomszíd	szomszéd
szomszídasszony	szomszédasszony
szomszídasszonyt	szomszédasszonyt
szomszídba	szomszédba
szomszídja	szomszédja
szomájábú	szobájából
szoni	szőni
szonnyan	szomjan
szonnyulva	szomjulva
szonnyúságába	szomjúságába
szonnyúságán	szomjúságán
szopottgombócfejű	szopottgombóc-fejű
szopástul	szopástól
szorgalams	szorgalmas
szorgoson	szorgosan
szoritják	szorítják
szorossan	szorosan
szorük	szőrük
szsaladni	szaladni
szultankisasszony	szultánkisasszony
szultánlisasszonyt	szultánkisasszonyt
szurják	szúrják
szurkáni	szurkálni
szurnak	szúrnak
szurni	szúrni
szuszszal	szusszal
szuóma	szalma
szájik	szájuk
szájjába	szájába
szájjából	szájából
szájoknak	szájuknak
szájokom	szájukon
szájrúl	szájról
száju	szájú
szájábul	szájából
szájábó	szájából
szájábúl	szájából
szálbó	szálból
szált	szállt
számu	számú
számítógép-gyártó	számítógépgyártó
szántanni	szántani
szántófődeken	szántóföldeken
száritsa	szárítsa
szárnyatollát	szárnytollát
szárnyikra	szárnyukra
szárnyom	szárnyam
szát	szállt
szátokot	szátokat
százbó	százból
szégyeljétek	szégyelljétek
szégyelletibe	szégyenletébe
szégyenletiben	szégyenletében
szégyenletté	szégyenlette
széjes	széles
széjin	szélén
széjire	szélére
széjjel-nézett	széjjelnézett
széjjelníz	széjjelnéz
székire	székére
székrül	székről
szélibe	szélébe
széliben	szélében
szélihe	széléhez
szélinél	szélénél
szélire	szélére
széliről	széléről
szélirűl	széléről
szélit	szélét
széllednek	szélednek
szélledni	széledni
széllin	szélén
széltibe-hosszába	széltében-hosszában
széltébe	széltében
széndioxid	szén-dioxid
széndioxid-kibocsátási	szén-dioxid-kibocsátási
széndioxid-kibocsátások	szén-dioxid-kibocsátások
szénvanót	szénvonót
szépenn	szépen
szépne	szépen
szépségire	szépségére
szépén	szépen
szérül	széjjel
szérőjéről	szerűjéről
széthorgya	széthordja
szétküldötte	szétküldte
szétkűdött	szétküldött
szétmönnyön	szétmenjen
szétszagassák	szétszaggassák
szétszagatja	szétszaggatja
szétszagatott	szétszaggatott
széttépőnk	széttépünk
széttöntözik	szétöntözik
szëm	szem
szëmed	szemed
szëmeit	szemeit
szëmëm	szemem
szëp	szép
szërszámnok	szerszámok
szërëncsés	szerencsés
szërëncsétlen	szerencsétlen
szërëncsétlenség	szerencsétlenség
szígyelje	szégyellje
szígyellette	szégyellte
szígyellősködött	szégyenlősködött
szígyen	szégyen
szíjakot	szíjakat
szíjja	szívja
szíjjel	széjjel
szíjjelmállott	széjjelmállott
szíjjelníz	széjjelnéz
szíjjelnízünk	széjjelnézünk
szíjjeltípte	széjjeltépte
szíke	széke
szíle	széle
szílibe	szélébe
szílibűl	széléből
szílin	szélén
szílire	szélére
szílirűl	széléről
szílit	szélét
szílníl	szélnél
színaranybló	színaranyból
színaranybúl	színaranyból
színin	színén
színy	szín
szíp	szép
szípen	szépen
szípenn	szépen
szírmát	szirmát
szítnízzenek	szétnézzenek
szívessen	szívesen
szívi	szíve
szívibe	szívébe
szívik	szívük
szívire	szívére
szívnifarktus	szívinfarktus
szívök	szívük
szóbó	szóból
szóga	szolga
szógálatot	szolgálatot
szógáljon	szolgáljon
szógálok	szolgálok
szógáltam	szolgáltam
szógáló	szolgáló
szógám	szolgám
szógámat	szolgámat
szógának	szolgának
szógát	szolgát
szógátak	szolgáltak
szóho	szóhoz
szójjëk	szóljon
szójtam	szóltam
szójëk	szóljon
szólalnyi	szólalni
szólanni	szólni
szólgállónak	szolgálónak
szólitod	szólítod
szólitsa	szólítsa
szólittál	szólítottál
szóllanak	szólnak
szóllani	szólni
szóllják	szólják
szóllott	szólt
szóllítgatták	szólítgatták
szóllította	szólította
szólnyi	szólni
szólítsá	szólíts
szóma	szalma
szóni	szólni
szónyi	szólni
szórul	szóról
szótak	szóltak
szótam	szóltam
szóuga	szolga
szóugált	szolgált
szóva	szóval
szóviában	szófiában
szóól	szól
szöbb	szebb
szögede	szeged
szögletibe	szögletébe
szögletje	szöglete
szögénnek	szegénynek
szöktyön	szökjön
szökté	szöktél
szökésit	szökését
szökőkútat	szökőkutat
szöllő	szőlő
szöllőbe	szőlőbe
szöllőben	szőlőben
szöllőfával	szőlőfával
szöllőjibe	szőlőjébe
szöllőnyitás	szőlőnyitás
szöllőt	szőlőt
szöllővel	szőlővel
szöme-szája	szeme-szája
szömeimme	szemeimmel
szömibe	szemébe
szömit	szemét
szömmel	szemmel
szörnyü	szörnyű
szörnyüséges	szörnyűséges
szöröncséd	szerencséd
szöröncséjjire	szerencséjére
szöröncsés	szerencsés
szöröncsésön	szerencsésen
szörözted	szerezted
szörözzön	szerezzen
szööögény	szegény
szöüke	szőke
szúcs	szűcs
szúrkálva	szurkálva
szücskébe	csücskébe
szüksíg	szükség
szüksíged	szükséged
szüksígek	szükségük
szüksígem	szükségem
szüleitül	szüleitől
szüleitő	szüleitől
szüleitűl	szüleitől
szüleji	szülei
szülejihöz	szüleihez
szülejinek	szüleinek
szület	születik
születet	született
születtetteket	születetteket
születésemtül	születésemtől
születéstül	születéstől
születëtt	született
születíssel	születéssel
születött	született
szüleém	szülőm
szülésnőt	szülésznőt
szülőköt	szülőket
szürkölet	szürkület
szürnyű	szörnyű
szürt	szűrt
szüved	szived
szüvel	szívvel
szüzanya	szűzanya
szőcs	szűcs
szőcshöz	szűcshöz
szőcsingje	szemölcse
szőcsnek	szűcsnek
szőcsnél	szűcsnél
szőcsről	szűcsről
szőcsöt	szűcsöt
szőllő	szőlő
szőllőskert	szőlőskert
szőllőt	szőlőt
szőnyi	szőni
szőr-férge	szőrféreg
szőriből	szőréből
szőrit	szőrét
szőrü	szőrű
szőüke	szőke
szűrit	szűrét
szűrött	szűrt
szűve	szíve
szűvel	szívvel
szűves	szíves
szűvesség	szívesség
szűvességet	szívességet
szűvességhez	szívességhez
szűvességnek	szívességnek
szűvire	szívére
szűzanyáhó	szűzanyához
szűzanyátúl	szűzanyától
szűzlevesön	szűzlevesen
sályos	súlyos
sáppadt	sápadt
sárkán	sárkány
sárkánnak	sárkánynak
sárkánt	sárkányt
sárkány-víz	sárkányvíz
sárkánybló	sárkányból
sárkányrul	sárkányról
sároznyi	sározni
sárt	sarat
sátorfádot	sátorfádat
sátoroktúl	sátoroktól
sátortul	sátortól
sázs	száz
sénkihe	senkihez
sétábúl	sétából
së	se
sëhol	sehol
sëm	sem
sëmmiféle	semmiféle
sëmmire	semmire
sëmmit	semmit
sënkit	senkit
síma	sima
símogatta	simogatta
símuljatok	simuljatok
símultak	simultak
sírnyi	sírni
síromot	síromat
sírtak-rítak	sírtak-ríttak
sírárkozott	siránkozott
sírárkoztak	siránkoztak
sírásho	síráshoz
sógorodval	sógoroddal
sógoromná	sógoromnál
sógoráho	sógorához
sógorátó	sógorától
sóhajtoz	sóhajtozik
sótalan	sótlan
sóér	sóért
sömöcsűt	szemölcsöt
sömörgöt	sömört
sömörögje	sömör
sönki	senki
söpröve	seprűvel
söprün	söprűn
söprüre	söprűre
söprüt	söprűt
söprüzzék	söprűzzék
söpörnyi	söpörni
sörpüt	söprűt
sörpűvel	söprűvel
sörényembűl	sörényemből
sörínyembűl	sörényemből
sötít	sötét
sötítsíg	sötétség
súgdostak	sugdostak
súkold	sulykold
súkot	sulykot
sülyedtek	süllyedtek
süppedett	süppedt
sürgésforgásból	sürgés-forgásból
sürt	sört
sürü	sűrű
sürüségen	sűrűségen
süssë	süss
süssőnk-főzzőnk	süssünk-főzzünk
sütnyi	sütni
sütt	sült
süttek	sütöttek
süttek-főztek	sütöttek-főztek
sütték	sütötték
sütyi	süti
sütyik-főzik	sütik-főzik
sütéshő	sütéshez
sütőlapáttó	sütőlapáttól
sütőtekenyő	sütőteknő
süvitt	süvít
sűdők	süldők
sűl	sül
sűlt	sült
sűreőven	sűrűn
sűrü	sűrű
sűrüjéből	sűrűjéből
sűrün	sűrűn
sűrüségbe	sűrűségbe
sűtőkemence	sütőkemence
t-mobil	t-mobile
t-mobiletól	t-mobile-tól
t-mobilt	t-mobile-t
tabad	szabad
tajicskába	talicskába
takarmányér	takarmányért
takaroggy	takarodj
takhod	csakhogy
talismánt	talizmánt
tallón	tarlón
talpaig	talpáig
talpok	talpuk
talpátó	talpától
taluseprővel	tollseprűvel
talyicskázását	talicskázását
talyiga	taliga
talyigakereket	taligakereket
talyigába	taligába
talyigán	taligán
talyigára	taligára
talyigát	taligát
találtá	találtál
talám	talán
talának	találnak
taláni	találni
talász	találsz
taláta	találta
tanitotta	tanította
tanu	tanú
tanuk	tanúk
tanukat	tanúkat
tanulnyi	tanulni
tanut	tanú
tanyárul	tanyáról
tanyër	tányér
taná	talál
tanácsdadója	tanácsadója
tanácslom	tanácsolom
tanál	talál
tanálja	találja
tanálják	találják
tanálkozik	találkozik
tanálkoznak	találkoznak
tanálkoznánk	találkoznánk
tanálkozott	találkozott
tanálkoztak	találkoztak
tanálkoztam	találkoztam
tanálnak	találnak
tanálni	találni
tanálod	találod
tanálok	találok
tanált	talált
tanálta	találta
tanáltak	találtak
tanáltam	találtam
tanáltatok	találtatok
tanáltunk	találtunk
tanáltá	találtál
tanálták	találták
tanároktúl	tanároktól
tanátam	találtam
tanáták	találták
tanátónk	találtunk
tanúlni	tanulni
tanúlt	tanult
tanúltabbak	tanultabbak
tarajja	taraja
tarisnya	tarisznya
tarisnyábul	tarisznyából
tarisnyájjon	tarisznyáljon
tarisnyájába	tarisznyájába
tarisnyájábúl	tarisznyájából
tarisnyáltassak	tarisznyáltassak
tarisnyát	tarisznyát
tarisznyábó	tarisznyából
tarka-barka	tarkabarka
tartanni	tartani
tartanyi	tartani
tartassz	tartasz
tartik	tartják
taszittsuk	taszítsuk
taszíjja	taszítja
tatték	tették
tavaji	tavalyi
tavakbó	tavakból
teaskanna	teáskanna
tebelülled	tebelőled
tebelőlled	tebelőled
tech-piacon	techpiacon
tech-szektorból	techszektorból
tegem	tegyem
tegnap-tegnapelőtt	tegnap
tegyëk	tegyék
tehen	tehén
tehenekhő	tehenekhez
tehenektül	tehenektől
tehenganajt	tehénganajt
tehenganyéba	tehénganéba
tehenit	tehenét
tehenjét	tehenét
tehenvel	tehénnel
tehenyire	tehenére
tehenól	tehénól
tehenólba	tehénólba
tehenök	tehenek
teherkomp-járat	teherkompjárat
tehetőnk	tehetünk
tehátlan	tehát
tehént	tehenet
tehín	tehén
tehínnel	tehénnel
tehínírt	tehénért
tej-tavak	tejtavak
tej-tó	tejtó
tejesen	teljesen
tejiben	tejében
tejibű	tejéből
tejibűl	tejéből
tejit	fejét
tejje	teje
tejvel	tejjel
tejér	tejért
tejöt	tejet
tekenyő	teknő
tekenyőből	teknőből
tekenyőn	teknőn
tekenyőre	teknőre
tekenyősbékává	teknősbékává
tekenő	teknő
tekenőbe	teknőbe
tekenője	teknője
tekenőt	teknőt
tekenővel	teknővel
tekeredjík	tekeredjék
tekergőbódorgó	tekergő-bódorgó
tekintetyi	tekintete
teknyőbe	teknőbe
teknyőre	teknőre
telefonica	telefónica
telefónica-t	telefónicát
telejs	teljes
telemerítötte	telemerítette
telepiu	telepiu
telepiú	telepiu
telesen	teljesen
televízió-gyárának	televíziógyárának
telhozta	telehozta
telidesteli	telides-teli
telisded-teli	telides-teli
telistele	telis-tele
telisteli	telis-teli
teljesedhetik	teljesedhet
teljesiti	teljesíti
teljesitik	teljesítik
teljesűl	teljesül
teljesűlt	teljesült
teljeültek	teljesültek
tellett-múlott	telt-múlt
telyi	teli
teláltam	találtam
telázsiho	stelázsihoz
temetiőbe	temetőbe
temetésire	temetésére
templombló	templomból
templombúl	templomból
templomho	templomhoz
templomunkot	templomunkat
tengerbő	temgerből
tengerinyúlat	tengerinyulat
tengör	tenger
tengörpartra	tengerpartra
tengört	tengert
tennap	tegnap
tennapi	tegnapi
tennyi	tenni
tenyeredvel	tenyereddel
tenyerit	tenyerét
tenyerivel	tenyerével
tenyerët	tenyerét
tepsüből	tepsiből
teremom	teremtőm
teremtom	teremtőm
teremtötte	teremtette
terennye	tenyere
teresitöm	teresítem
terhivel	terhével
terigették	teregették
terigetve	teregetve
teritett	terített
teriti	teríti
teritse	terítse
terittetött	teríttetett
teritő	terítő
teritőt	terítőt
termékdíj-köteles	termékdíjköteles
termékdíj-törvényben	termékdíjtörvényben
termékportfoliójuk	termékportfóliójuk
termésit	termését
termésrű	termésről
természetiben	természetében
természetü	természetű
termött	termett
terringette	teringette
tervi	terve
terídd	terítsd
terítennek	terítenek
terítyi	teríti
terömbe	terembe
terömjünk	teremjünk
tesco-globál	tesco-global
tesszünk	teszünk
testin	testén
testire	testére
testiről	testéről
testivel	testével
testrészletjét	testrészletét
testtűl	testtől
testvéreihe	testvéreihez
testvérit	testvérét
testvérivel	testvérével
testvérje	testvére
testvéröm	testvérem
testvíre	testvére
testvíredet	testvéredet
testvírek	testvérek
testvírem	testvérem
testvíreteket	testvéreteket
testvírinek	testvérének
testvírit	testvérét
testvírjei	testvérei
testyiket	testüket
testyire	testére
testyit	testét
testök	testek
testökkel	testükkel
testöm	testem
tesvériknek	testvérüknek
tesvérünknek	testvérünknek
tesvíredír	testvéredért
teszen	tesz
teteire	tetejére
tetejibe	tetejébe
tetejiben	tetejében
tetejin	tetején
tetejire	tetejére
tetejirűl	tetejéről
tetejit	tetejét
tetejitő	tetejétől
tetejénn	tetején
tetette	tettette
tetszésöd	tetszésed
tettiírt	tettéért
tetté	tettél
tetücsipés	tetűcsípés
tetüt	tetűt
tetőtál	tetőtől
tetőtöl	tetőtől
tetőtő	tetőtől
teves	tetves
teépelőttem	tépelődtem
teőle	tőle
teőlë	tőle
thueganak	thuegának
thyssenkrupp-tól	thyssenkrupptól
tibett-lábott	tébelt-lábolt
tik	ti
tikerbe	tükörbe
tiktyaik	tyúkjaik
tisssza	tisza
tiszaszöllős	tiszaszőlős
tiszaszőllős	tiszaszőlős
tiszaszőllősön	tiszaszőlősön
tisztektűl	tisztektől
tiszteletire	tiszteletére
tiszteletiére	tiszteletére
tiszteletkel	tisztelettel
tisztessígesen	tisztességesen
tisztessígesenn	tisztességesen
tisztessígtudással	tisztességtudással
tisztitóvíz	tisztítóvíz
tisztító-emberré	tisztítóember
tisztítóvízes	tisztítóvizes
tiszábó	tiszából
titkomot	titkomat
titkulták	titkolták
tiz-husz	tíz-húsz
tiz-tizenöt	tíz-tizenöt
tizönkét	tizenkét
tiéd	tiéd
tiétek	tiétek
tiírted	teérted
to'm	tudom
tobább	tovább
tojanak	tojjanak
tojjúba	tollba
tojnyi	tojni
tojából	tojásból
tojássát	tojását
tojófelit	tojófelét
tojúsöprűt	tollsöprűt
tollszödővel	tollszedővel
tolluba	tollba
tolluban	tollban
tollut	tollat
tollúnak	tollnak
tolvajokot	tolvajokat
tolyik	tojik
tolyásban	tojásban
tolyást	tojást
tolyúsëpreő	tollseprű
topló	tapló
toplóra	taplóra
toplót	taplót
toranyát-boranyát	tornyát-boronyát
tornácró	tornácról
torockó-szentgyörgyre	torockószentgyörgyre
torokfájos	torokfájós
torontetőre	toronytetőre
toronybúl	toronyból
torturára	tortúrára
tosznkosnak	toszonkos
tovaj	tolvaj
továbbsántált	továbbsántikált
továbra	továbbra
tovébb	tovább
trika	trikha
tréfáni	tréfálni
tróbádd	próbáld
tróbáljónk	próbáljunk
tróbát	próbát
trónró	trónról
tudgya	tudja
tudománt	tudományt
tudtat	tudta
tudónk	tudunk
tudósgyerök	tudósgyerek
tuggya	tudja
tuggyon	tudjon
tuggyá	tudjál
tuggyája	tudása
tuggyák	tudják
tugygya	tudja
tul	túl
tulajdonképen	tulajdonképpen
tulajdonossával	tulajdonosával
tulajodrészért	tulajdonrészért
tulipántos	tulipános
tulipántot	tulipánt
tulsó	túlsó
tulvilági	túlvilági
tundérlány	tündérlány
tunna	tudna
tunnak	tudnak
tunni	tudni
tunná	tudná
tunnád	tudnád
tunnám	tudnám
tuná	tudná
tur	túr
turon	túron
turásba	túrásba
turök	tűrök
tuttak	tudtak
tutták	tudták
tutúl	tutul
tutúlásával	tutulásával
tuvább	tovább
tvrdik	tvrdík
tyuk	tyúk
tyukja	tyúkja
tyukjai	tyúkjai
tyuklopót	tyúklopót
tyuknak	tyúknak
tyukok	tyúkok
tyukokat	tyúkokat
tyukoknak	tyúkoknak
tyukolhoz	tyúkólhoz
tyukom	tyúkom
tyukot	tyúkot
tyukseg	tyúksegg
tyuksegg	tyúksegg
tyuksegget	tyúksegget
tyukszeme	tyúkszeme
tyuktetű	tyúktetű
tyuktetűtől	tyúktetűtől
tyukunk	tyúkunk
tyukász	tyúkász
tyukól	tyúkól
tyukólak	tyúkólak
tyukólat	tyúkólat
tyukólba	tyúkólba
tyukólban	tyúkólban
tyukültető	tyúkültető
tyík	ti
tyúkhus	tyúkhús
tyúkokot	tyúkokat
tyúkpalláson	tyúkpadlás
tyúkseggës	tyúksegges
tyü	tyű
tyűh	tyű
tágos	tágas
tájrul	tájról
tájékárul	tájékáról
tálentom	tálentum
táltos-fogait	táltosfogait
táltos-forma	táltosforma
táltossaink	táltosaink
táltus	táltos
táltusok	táltosok
tám	tán
támastas	támasztasz
táncuó	táncol
táncuónak	táncolnak
táncuónyi	táncolni
tánczónak	táncolnak
táncónak	táncolnak
táncúnak	táncolnak
tángyér	tányér
tányír	tányér
társaitó	társaitól
tássat	társat
tátas	táltos
táti	tátja
tátos	táltos
tátosbúl	táltosból
tátoscipője	táltoscipő
tátosforma	táltosforma
tátosféle	táltosféle
tátoshoz	táltoshoz
tátoskollégái	táltoskollégái
tátosnak	táltosnak
tátosné	táltosné
tátosok	táltosok
tátosokkal	táltosokkal
tátosoknak	táltosoknak
tátosomért	táltosomért
tátosra	táltosra
tátosrul	táltosról
tátosról	táltosról
tátossal	táltossal
tátossá	táltossá
tátosság	táltosság
tátosságnak	táltosságnak
tátost	táltost
tátostul	táltostól
tátosát	táltosát
tátosával	táltosával
táttos	táltos
tátus	táltos
tátusnak	táltosnak
tátusok	táltosok
tátussá	táltossá
tátussâ	táltossá
távfűtő-cégeket	távfűtőcégeket
távool-keleti	távol-keleti
távul	távol
távulocska	távolocska
távurról	távolról
tébe	tejbe
tébűl	tejből
tégöd	téged
tégödöt	téged
téj	tej
téjbe	tejbe
téjben	tejben
téjfölös	tejfölös
télen-nyáron	nyáron
télleg	tényleg
ténleg	tényleg
tényért	tányért
tépelodött	tépelődött
térdekalácsába	térdkalácsába
térdignél	térdnél
térdit	térdét
térdétő	térdétől
térgyedet	térdedet
térgyeljünk	térdeljünk
térgyem	térdem
térgyemig	térdemig
térgyep	térden
térgyig	térdig
térgyin	térdén
térgyit	térdét
térgyitő	térdétől
térgyre	térdre
térgyéig	térdéig
térgyére	térdére
térgyét	térdét
térileg	tényleg
térsíg	térség
tértül	tértől
tésasszony	ténsasszony
téssz	teszel
tészem	teszem
tészen	tesz
tétó	tejtó
tévejedett	tévelyedett
tévé-telep	tévételep
të	te
tëdd	tedd
tënnyi	tenni
tëszik	teszik
tësznek	tesznek
tëszëm	teszem
tëttem	tettem
tíged	téged
tígy	tégy
tík	ti
típett	tépett
típte	tépte
tírtek	tértek
títetett	tétetett
tíz-tezenkettő	tíz-tizenkettő
tízs	tíz
tízsorosan	tízszeresen
tóbúl	tóból
tódotta	toldotta
tójjatok	tojjatok
tójnak	tojnak
tólok	szólok
tólvilágra	túlvilágra
tórt	tort
tótam	szóltam
tótá	szóltál
többfélirűl	többféléről
többitűl	többitől
tödd	tedd
tögye	tegye
tögyek	tegyek
töhetetlen	tehetetlen
tökit	tökét
töle	tőle
töllök	tőlük
töltsíl	töltsél
töltsítek	töltsétek
töltöttík	töltötték
tömént	tömjént
töpdöste	köpdöste
töpröngeni	töprengeni
törjík	törjék
törlejével	törlőjével
törpérő	törpéről
törtint	történt
törtík	törték
törtínik	történik
törtínjík	történjék
törtínt	történt
törvéntelen	törvénytelen
törvíny	törvény
törvínykeznek	törvénykeznek
törvínyre	törvényre
törádjön	törődjön
töröktemplom	török-templom
töröktemplomnál	török-templomnál
törökökrül	törökökről
törököktű	törököktől
törüjük	töröljük
törülközőkendeje	törülközőkendője
törődjík	törődjék
törőgessë	törölgessél
törőgyik	törődik
tösz	tesz
tösznek	tesznek
tötte	tette
töttél	tettél
tövestő	tövestől
tövibe	tövébe
töviben	tövében
töviből	tövéből
tövinél	tövénél
tövirül	tövéről
töviről	tövéről
töviset	tövist
töviskes	tövises
tövit	tövét
tövött	tett
töügyfalevél	tölgyfalevél
túd	tud
túdja	tudja
túdjon	tudjon
túdni	tudni
túdom	tudom
túdos	tudós
túdós	tudós
túdósasszony	tudósasszony
tújárok	túljárok
túlonnan	túlnan
túnan	túlnan
túnnyi	tudni
túrkálni	turkálni
túrsó	túlsó
túskó	tuskó
túskót	tuskót
tússó	túlsó
tútúl	tutul
tútúlás	tutulás
tü	ti
tüjibe	tűjébe
tükörbűl	tükörből
tükörtő	tükörtől
tükörön	tükrön
tüle	tőle
tülle	tőle
tüllök	tőlük
tünnek	tűnnek
tünni	tűnni
tünnöm	tűnnöm
tünt	tűnt
tünődött	tűnődött
türtőztetnyi	türtőztetni
türés-tagadás	tűrés-tagadás
türüjje	törölje
türülköző	törölköző
tüskés-disznó	tüskésdisznó
tüskön-bokron	tüskén-bokron
tüsszenís	tüsszentés
tüt	tűt
tüvel	tűvel
tüviskeken	töviseken
tüz	tűz
tüzbe	tűzbe
tüzhelybe	tűzhelybe
tüzhelyhez	tűzhelyhez
tüzhelyről	tűzhelyről
tüznek	tűznek
tüznyi	tűzni
tüzve	tűzve
tüzön	tűzön
tőcsér	tölcsér
tőgyi	tőgye
tőgyibű	tőgyéből
tőke-befektetés	tőkebefektetés
tőlek	tőlük
tőlle	tőle
tőlled	tőled
tőllem	tőlem
tőllik	tőlük
tőllünk	tőlünk
tőszdezárás	tőzsdezárás
tőtet	töltet
tőthetett	tölthetett
tőtt	telt
tőtött	töltött
tőtötte	töltötte
tőzsdenapai	tőzsdenapi
tűkrött	tükröt
tűkörbe	tükörbe
tűköt	tűket
tűle	tőle
tűlle	tőle
tűlled	tőled
tűllem	tőlem
tűlök	tőlük
tűntetni	tüntetni
tűröm-olaja	tűrömolaja
tűzbűl	tűzből
tűze	tüze
tűzes	tüzes
tűzkő-öltözetet	tűzkőöltözetet
uccába	utcába
uccán	utcán
uccára	utcára
uccú	uccu
udva	udvar
udvarbúl	udvarból
udvarjokba	udvarukba
udvarrúl	udvarról
udvartúl	udvartól
udvarábúl	udvarából
udvarárló	udvaráról
ugorkán	uborkán
ugorkát	uborkát
ugy	úgy
ugyanannak	ugyanannak
ugyannyira	úgyannyira
ugyhogy	úgyhogy
ugyi	ugye
ugyis	úgyis
ugymond	úgymond
ugynevezett	úgynevezett
ugyse	úgyse
ugyszintén	úgyszintén
ugyé	ugye
uj	új
uj-delhi	új-delhi
ujabb	újabb
ujabban	újabban
ujan	olyan
ujból	újból
ujdonságot	újdonságot
ujdonsült	újdonsült
ujhold	újhold
ujholdat	újholdat
ujholdban	újholdban
ujholdkor	újholdkor
ujholdra	újholdra
ujhód	újhold
ujhódkor	újholdkor
ujjabban	újabban
ujjabögyét	ujjbegyét
ujjadró	ujjadról
ujjadrúl	ujjadról
ujjitaná	újítaná
ujjval	ujjal
ujjárúl	ujjáról
ujjáva	ujjával
ujjév	újév
ujra	újra
ujszülött	újszülött
ujszülöttet	újszülöttet
ujság	újság
ujságkor	újságkor
ujságot	újságot
ujul	újul
ujunk	ujjunk
uját	ujját
ujával	ujjával
ujév	újév
ujévkor	újévkor
ukrtelekom	ukrtelecom
ullan	olyan
ulyan	olyan
ulyankor	olyankor
unnat	onnan
ur	úr
uralkodhatik	uralkodhat
uralkogyik	uralkodik
uramot	uramat
uraságokhó	uraságokhoz
urasán	urasan
urfelmutatáskor	úrfelmutatáskor
urfelmutatásra	úrfelmutatásra
urfi	úrfi
urfiak	úrfiak
urfit	úrfit
urilag	úrilag
urnapi	úrnapi
urnapkor	úrnapkor
urok	urak
urral	úrral
urvacsora	úrvacsora
urvacsorakor	úrvacsorakor
uráhó	urához
urám	uram
urékho	úrékhoz
usgyi	uzsgyi
ustora	ostora
ustorral	ostorral
ustort	ostort
ustorával	ostorával
uszitotta	uszította
utasitts	utasíts
utban	útban
utbul	útból
utból	útból
utczára	utcára
utcáró	utcáról
uthoz	úthoz
utifűvet	útifüvet
utikészség	útikészség
utközben	útközben
utlosó	utolsó
utnak	útnak
utolja	utója
uton	úton
uton-utfélen	úton-útfélen
utonjáró	útonjáró
utra	útra
utszéli	útszéli
utunkot	utunkat
utánakajbált	utánakiabált
utánaszállott	utánaszállt
utánna	utána
utánnad	utánad
utánnadobta	utánadobta
utánnaindulok	utánaindulok
utánnairamodom	utánairamodom
utánnam	utánam
utánnament	utánament
utánnatok	utánatok
utánno	utána
utánnok	utánuk
utánnuk	utánuk
utánok	utánuk
utánúk	utánuk
utófinszírozásának	utófinanszírozásának
utójára	utoljára
utól	utol
utóljára	utoljára
utólsó	utolsó
utólérnek	utolérnek
utólérte	utolérte
utón	úton
utóssó	utolsó
utósó	utolsó
uzsgyé	uzsgyi
vaclac	vaclav
vadcsanalat	vadcsalán
vaddisztó	vaddisznó
vaddisztócsorda	vaddisznócsorda
vaddisztók	vaddisznók
vaddisztókirály	vaddisznókirály
vadlúdak	vadludak
vadonatút	vadonatúj
vadrozsa	vadrózsa
vadállatokhó	vadállatokhoz
vadállatokot	vadállatokat
vadászatró	vadászatról
vagdalnyi	vagdalni
vagdânyi	vagdalni
vagynak	vannak
vagyol	vagy
vagyonunkot	vagyonunkat
vagyorára	vacsorára
vagyónk	vagyunk
vajdaságru	vajdaságról
vajjon	vajon
vakarut	vakarót
vakitotta	vakította
valaholott	valahol
valahon	valahol
valahun	valahol
valahunn	valahol
valahunnand	valahonnan
valahunnét	valahonnét
valahunnít	valahonnét
valakitül	valakitől
valamejjik	valamelyik
valamelyiktek	valamelyikőtök
valamelyiköt	valamelyiket
valamelyitek	valamelyikőtök
valamelyőtök	valamelyikőtök
valamennyiteket	valamennyieteket
valamennyitöket	valamennyiőtöket
valamikép	valamiképp
valamiképen	valamiképpen
valamikó	valamikor
valamilyét	valamijét
valamiszerént	valamiszerint
valamiér	valamiért
valamni	valami
valamék	valamelyik
valaszinüleg	valószínűleg
valdemar	valdemar
valóba	valóban
valójába	valójában
varangyékos	varangyos
vargahalomhoz	varga-halomhoz
varják	varrják
varnyi	varrni
varosban	városban
varrnivaólt	varrnivalót
varrnyi	varrni
varrótü	varrótű
varrótüvel	varrótűvel
varrótőt	varrótűt
vart	varrt
varázs-szavakat	varázsszavakat
varázskönyvekbő	varázskönyvekből
varázslá	varázsló
varázslótló	varázslótól
varázsszókot	varázsszókat
vasakér	vasakért
vasbékó	vasbéklyó
vasbúl	vasból
vasgyűrü	vasgyűrű
vasiskátulya	vasskatulya
vasiskátulyában	vasskatulyában
vasiskátulyát	vasskatulyát
vaskamarába	vaskamrába
vasránap	vasárnap
vastekenyő	vasteknő
vastekenő	vasteknő
vasteknyő	vasteknő
vasvát	vasvár
vasárnaponn	vasárnapon
vasípüllet	vasépület
vasórrú	vasorrú
vattok	vagytok
vaárta	várta
vaâtozása	változása
vaól	való
vaólban	valóban
vaólk	valók
vaólság	valóság
vaólsággal	valósággal
vaólt	volt
vaóna	volna
vaót	volt
vaótam	voltam
vedérrel	vederrel
vedëg	vendég
vegyík	vegyék
vej	vő
vejemöt	vejemet
vejit	vejét
vejök	vejük
velek	velük
velet	veletek
velkencei-tóban	velencei-tóban
vellát	villát
velë	vele
velök	velük
velők	velük
velőnk	velünk
velűnk	velünk
vendégök	vendégek
vendégűték	vendégelték
vendëg	vendég
vendëgem	vendégem
vendëget	vendéget
vendëgfog	vendégfog
vendíg	vendég
vendígek	vendégek
vendíglőbe	vendéglőbe
vendíglőben	vendéglőben
vendíglőnek	vendéglőnek
vendígsígbe	vendégségbe
verbung	verbunk
verededni	verekedni
verekesznek	verekszenek
verendájok	verandájuk
veres	vörös
veresből	vörösből
veresebb	vörösebb
vereset	vöröset
vereshagymát	vöröshagymát
vereshangyák	vöröshangyák
veresre	vörösre
verességnek	vereségnek
veresét	vöröset
vergőgyik	vergődik
vertík	verték
veréb-páva	verébpáva
veréb-pávát	verébpáva
veselködésbe	veselkedésbe
vesszőbő	vesszőből
vesszőköt	vesszőket
vessétök	vessétek
veszekegyik	veszekedik
veszekeszünk	veszekszünk
veszekösznek	veszekednek
veszen	vesz
veszniök	veszniük
veszteség-tervét	veszteségtervét
vesztit	vesztét
vesztíl	vesztél
vetettíd	vetetted
vetillőt	vetélőt
vettík	vették
vetëtt	vetett
vetísnek	vetésnek
vetök	vetek
vetőlapátjok	vetőlapátjuk
vetőllőt	vetélőt
vezérbül	vezérből
vezérök	vezérük
vezéröknek	vezérüknek
veérbeő	vérből
vgy	vagy
vicceljön	vicceljen
videojátékkonzolának	videojáték-konzoljának
videókamerák	videokamerák
vigan	vígan
vigilia	vigília
vigiliáján	vigíliáján
viginé	végénél
vigire	végére
vigyé	vigyél
vigyík	vigyék
vihedd	viheted
vikotálodnának	vikotálódnának
vilijáján	viliáján
viliájájig	viliájáig
villiáján	viliáján
villámlástu	villámlástól
világhó	világhoz
világit	világít
világitó	világító
világonátállátónak	világonátallátónak
világrú	világról
világér	világért
világétt	világért
vilégossága	világossága
vinnyi	vinni
vinálnak	csinálnak
vinítva	vonítva
viradtig	virradatig
viradóra	virradóra
virit	virít
virradaóra	virradóra
virradióra	virradóra
virradott	virradt
virágokbúl	virágokból
virágokot	virágokat
virágoskerbe	virágoskertbe
virës	véres
visa-kártya-birtokosok	visa-kártyabirtokosok
viselkedet	viselkedett
viselkedíse	viselkedése
visellős	viselős
visit	visít
visitást	visítást
visitását	visítását
visszaeresztötte	visszaeresztette
visszaesött	visszaesett
visszafeküdött	visszafeküdt
visszafordúl	visszafordul
visszafordút	visszafordult
visszagyönné	visszajönnél
visszagyössz	visszajössz
visszagyöttőnk	visszajöttünk
visszagyövök	visszajövök
visszagyün	visszajön
visszagyütt	visszajött
visszahítta	visszahívta
visszajő	visszajön
visszajőnek	visszajönnek
visszajőni	visszajönni
visszakézbeő	visszakézből
visszaküldötte	visszaküldte
visszaküldötték	visszaküldték
visszamasérozott	visszamasírozott
visszamenek	visszamegyek
visszamenyen	visszamegy
visszamönt	visszament
visszanéznyi	visszanézni
visszaníz	visszanéz
visszanízett	visszanézett
visszarakata	visszarakta
visszasirják	visszasírják
visszatettík	visszatették
visszjön	visszajön
visszket	viszket
visszáság	visszásság
viszbűl	vízből
viszen	visz
viszked	viszket
viszszament	visszament
viszájjárú	visszájáról
viszájárú	visszájáról
viszön	visz
vittík	vitték
vitáz	vitéz
vitézs	vitéz
vitéztő	vitéztől
vitézök	vitézük
vivnyi	vívni
vivókat	vívókat
vizbe	vízbe
vizbefúlt	vízbefúlt
vizben	vízben
vizböl	vízből
vizből	vízből
vizcseppeket	vízcseppeket
vizejje	vizezze
vizeleni	vizelni
vizelettyivel	vizeletével
vizell	vizel
vizellete	vizelete
vizeni	vizelni
vizhez	vízhez
vizhöz	vízhez
viziben	vizében
vizivel	vizével
vizkeresztkor	vízkeresztkor
viznek	víznek
vizre	vízre
vizszinre	vízszintre
vizszintesen	vízszintesen
vizze	vízzel
vizé	vízért
viégien	végén
viégig	végig
viégién	végén
viékába	vékába
vién	vén
vlami	valami
vlee	vele
vodafont	vodafone-t
volná	volna
volskwagen	volkswagen
voltanak	voltak
voló	való
vona	volna
vonat-tenderét	vonattenderét
vonatkőtségre	vonatköltségre
vonit	vonít
vonitanak	vonítanak
vonyit	vonyít
vonúlt	vonult
vout	volt
voút	volt
vád-ponttal	vádponttal
vágjék	vágjon
vágjó	vágja
vágnyi	vágni
vágyakodott	vágyakozott
vágóhidra	vágóhídra
vájogból	vályogból
vájura	vályúra
vájújába	vályújába
vákta	vágta
váktatott	vágtatott
válallat	vállalat
válasszonak	válasszanak
választattok	választottak
választyák	választják
válhatná	válhatnál
vállakozói	vállalkozói
vállalat-felvásárlások	vállalatfelvásárlások
vállalat-felvásárlásokkal	vállalatfelvásárlásokkal
vállalatcsopothoz	vállalatcsoporthoz
vállalatfelvásárlási	vállalat-felvásárlási
vállalatkarcsúsítási	vállalat-karcsúsítási
vállik	válik
vállni	válni
vállárul	válláról
vállás	válás
válnyi	válni
válott	vált
változatalan	változatlan
változnyi	változni
változtatnyi	változtatni
vályu	vályú
vályujába	vályújába
vályut	vályút
vándorónak	vándorolnak
vándorótak	vándoroltak
vándorútjokat	vándorútjukat
várakozásosk	várakozások
várambúl	váramból
várast	várost
várbul	várból
várbúl	várból
várgyon	várjon
várjonak	várjanak
várjá	várj
várnyi	várni
városbúl	városból
várossa	városa
várossába	városába
várossán	városán
várossának	városának
várossát	városát
várostyák	városatyák
városunkot	városunkat
városvégére	városvégre
városvígen	városvégen
vártánl	vártnál
vásznakt	vásznat
vászonbó	vászonból
vászonnémű	vászonnemű
vászonnéművel	vászonneművel
vásárbó	vásárból
vásáronn	vásáron
vásárró	vásárról
vátott	váltott
vátoznak	változnak
vátozott	változott
vátozzon	változzon
vázsonyra	vászonra
védlő	vedlő
végedes-végig	véges-végig
végibe	végébe
végiben	végében
végig-hossig	végig-hosszig
végighuzza	végighúzza
végigsimitunk	végigsimítunk
végigszaladott	végigszaladt
végigsímította	végigsimította
végin	végén
véginek	végének
végire	végére
végit	végét
végivel	végével
végre-végre	végre
végta	vágta
végtire	végtére
végégig	végéig
végín	végén
végőnk	végünk
végűl	végül
véla	vele
véletleneő	véletlenül
vélle	vele
vélled	veled
véllek	velük
véllekedett	vélekedett
véllem	vélem
vélletek	veletek
véllik	velük
véllünk	velünk
vélë	vele
vélük	velük
vénasszon	vénasszony
vénaszszonyhoz	vénasszonyhoz
vénaszszonynak	vénasszonynak
vénségire	vénségére
vénűl	vénül
véressek	véresek
vérható	várható
véri	vére
vérit	vérét
vérivel	vérével
vérveres	vérvörös
vérös	véres
vëgig	végig
vëgyë	vegye
vëkába	vékába
vëlë	vele
vën	vén
vësz	vész
vësznek	vesznek
vígadtak	vigadtak
vígasság	vigasság
vígasztalta	vigasztalta
vígasztalásom	vigasztalásom
vígaz	vígan
víge	vége
vígez	végez
vígezte	végezte
vígeztettek	végeztettek
vígeztivel	végeztével
vígig	végig
vígighalad	végighalad
vígigmenyünk	végigmegyünk
vígin	végén
vígire	végére
vígit	végét
vígon	vígan
vígre	végre
vígül	végül
víhattak	vívhattak
víka	véka
víkát	vékát
vín	vén
vínak	vívnak
vínasszonnyal	vénasszonnyal
vínasszony	vénasszony
vínasszonyt	vénasszonyt
víni	vívni
vínia	vívnia
vínyebbik	vénebbik
víradtkor	virradatkor
víreset	véreset
víssza	vissza
vítte	vitte
vívik	vív
vívásná	vívásnál
vízbő	vízből
vízet	vizet
vízibe	vizébe
vízirt	vízért
vízkelezőt	vízkezelőt
víztelenségiről	víztelenségéről
víztűl	víztől
vízírt	vízért
vó	volt
vólt	volt
vóltak	voltak
vón	volna
vóna	volna
vónák	volnék
vónálak	volnálak
vónék	volnék
vór	volt
vót	volt
vótak	voltak
vótam	voltam
vótunk	voltunk
vótá	voltál
vótál	voltál
vóut	volt
vóút	volt
vödörbű	vödörből
vögyél	vegyél
vöröstengerbe	vörös-tengerbe
vöszi	veszi
vöszöd	veszed
vöszöm	veszem
vöt	volt
vött	vett
vövött	vett
vút	volt
vüsznek	visznek
vőfiény	vőfély
vőfények	vőfélyek
vőgy	völgy
vőgybe	völgybe
vőgyön	völgyön
vőjjinek	vőjének
vőjjit	vőjét
vőlegénnek	vőlegénynek
vőlegíny	vőlegény
wabererís	waberer's
yúkok	tyúkok
zamankó	zimankó
zamankóval	zimankóval
zarow-ban	zarowban
zeg-zugát	zegzugát
zelletségöm	zelletségem
zenes	zenés
zivatarkó	zivatarkor
zsebbeváól	zsebbevaló
zsebbeváólt	zsebbevalót
zsebibe	zsebébe
zsebiben	zsebében
zsebibő	zsebéből
zsebiből	zsebéből
zsebihez	zsebéhez
zsebjét	zsebét
zsebkendőjibe	zsebkendőjébe
zsebkendőjibő	zsebkendőjéből
zsebkendőjivel	zsebkendőjével
zsebkésit	zsebkését
zsemlébűl	zsemléből
zsenge	zsenge
zsidaóho	zsidóhoz
zsidóktúl	zsidóktól
zsippzsupp	zsipp-zsupp
zsiros	zsíros
zsivány-tanyára	zsiványtanyára
zsupot	zsúpot
zsuppsz	zsupsz
zsuzsikárú	zsuzsikáról
zsákokot	zsákokat
zsákuk	zsákjuk
zsírónk	zsírunk
zuza	zúza
zuzmarás	zúzmarás
zuzmarával	zúzmarával
zuzája	zúzája
zuzájukat	zúzájukat
zuzáját	zúzáját
zuzánkat	zúzánkat
zuzát	zúzát
zádában	zárdában
záporessőü	záporeső
zárnyi	zárni
zárüló	záruló
zércsengő	rézcsengő
zën	én
zöldet-vereset	zöldet-vöröset
zúdittanak	zúdítanak
ződ	zöld
ződbűl	zöldből
ződág	zöldág
Ëccër	egyszer
Ëgyszër	egyszer
Ëgyszërcsak	egyszercsak
Ëleég	elég
ábrázattyát	ábrázatát
ád	ad
ádám-bűzt	ádámbűzt
ágaot	ágat
ágassat	ágast
ágastul-bogastul	agastól-bogastól
ágrúl	ágról
águ	ágú
ágyből	ágyból
ágyokba	ágyukba
ágyrul	ágyról
ágyáho	ágyához
ágyónk	ágyunk
áhítat	áhitat
áldozatúl	áldozatul
áldásbó	áldásból
áldástokat	áldásotokat
álj	állj
áljon	álljon
államkimcstártól	államkincstártól
állana	állna
állandójan	állandóan
állani	állni
állanod	állnod
állanunk	állnunk
állanyi	állni
állanál	állnál
állanánk	állnánk
állapodniok	állapodniuk
állapotja	állapota
állat-alakban	állatalakban
állatjába	állatába
állatját	állatát
állatjával	állatával
állatokot	állatokat
állatók	állatok
állit	állít
állitanak	állítanak
állitják	állítják
állitom	állítom
állittom	állítom
állittsák	állítsák
állitva	állítva
állitólag	állítólag
álljonak	álljanak
állkapczáját	állkapcáját
állniok	állniuk
állotra	állatra
álltal	által
álltának	álltak
állyék	álljék
állëtva	állítva
állítottta	állította
álmodol	álmodsz
álmossak	álmosak
álta	által
általmegyen	általmegy
általra	általa
álásan	alássan
ámment	áment
ámodik	álmodik
ángyitó	ángyitól
áprillillillis	április
áprillillis	április
áradatja	áradata
árbevételnövekedés	árbevétel-növekedés
árbevételnövekedése	árbevétel-növekedése
árbevételszinthez	árbevétel-szinthez
árfolyam-sávját	árfolyamsávját
árfolyampoliikáról	árfolyampolitikáról
ármenetileg	átmenetileg
árnyíkos	árnyékos
árnyíkában	arnyékában
árokbúl	árokból
árol	árul
árolnék	árulnék
árolt	árult
árpa-kötni	kötni
árpádnak	Árpádnak
áruház-láncnak	áruházláncnak
árább	arrébb
árús	árus
árúsnak	árusnak
árúsok	árusok
áskáóldni	áskálódni
ásnyi	ásni
áspis-kigyó	áspiskígyó
áspis-kigyóval	áspiskígyóval
átaladja	általadja
átaladják	általadják
átaladta	általadta
átaladták	általadták
átalbucskázott	általbucskázott
átalbukik	általbukik
átalbújni	általbújni
átalbütyközteti	átalbütyközteti
átalcsapni	általcsapni
átalcsapom	általcsapom
átalcsapott	általcsapott
átaldobta	általdobta
átalevez	általevez
átalgázolt	általgázol
átalhozom	általhozom
átaljutottak	általjutottak
átaljutsz	általjutsz
átaljön	általjön
átallátogatott	átlátogatott
átallépett	átlépett
átalléptek	átléptek
átalmehettek	átmehettek
átalmenned	átmenned
átalmenni	átmenni
átalment	átment
átalmászott	átmászott
átalmönyön	átmegy
átaltörhetett	áttörhetett
átaltörte	áttörte
átalugrott	átugrott
átalvarázsollak	átvarázsollak
átalvergődött	átvergődött
átalvette	átvette
átalviszlek	átviszlek
átalérje	általér
átalértek	általértek
átalúszik	átúszik
átalúsznak	általúsznak
átat	áltat
áthajitja	áthajítja
áthajitják	áthajítják
átkajabálták	átkiabáltak
átlopakodhassék	átlopakodhasson
átlábolni	átlábal
átlëpik	átlépik
átlíp	átlép
átmenek	átmegyek
átmégy	átmész
átmönt	átment
átnyujtott	átnyújtott
átnyujtotta	átnyújtotta
átoladta	átadta
átt	át
áttőrülgeted	áttörölgeted
átvennyi	átvenni
átvergelődni	átvergődni
átváltoztatád	átváltoztattad
átán	aztán
átírhetett	átérhetett
átúgorja	átugorja
ázs	az
ázzík	ázzon
ébredel	ébredsz
ébredeznyi	ébredni
ébredjön	ébredjen
ébresztenni	ébreszteni
ébresztöttél	ébresztettél
écakára	éjszakára
éccaka	éjszaka
éccakai	éjszakai
éccakakákon	éjszakákon
éccakáján	éjszakáján
éccakára	éjszakára
éccakázás	éjszakázás
écczaka	éjszaka
écczakának	éjszakának
écczakára	éjszakára
éd'sanyám	édesanyám
édesannya	édesanya
édesanyika	édesanya
édesanyjok	édesanyjuk
édesanyámot	édesanyámat
édesanyámval	édesanyámmal
édesapjok	édesapjuk
édesapámot	édesapámat
édesapámval	édesapámmal
édesatyjik	édesatyjuk
édesfiukkal	édesfiúkkal
édessígre	édességre
édws	édes
édës	édes
édös	édes
édösanyját	édesanyját
édösanyám	édesanyám
édösapám	édesapám
éfiak	ifjak
éfiakat	ifjakat
éfiú	ifjú
éfjú	ifjú
éfé	éjfél
éfél	éjfél
éféli	éjféli
éfélig	éjfélig
éfélikor	éjfélkor
égbül	égből
égrűl	égről
égött	égett
éhel	éhen
éhessen	éhesen
éhezniök	éhezniük
éhinségtől	éhínségől
éhségibe	éhségébe
éhségit	éhségét
éhön	éhen
éhös	éhes
éjcakának	éjszakának
éjczaka	éjszaka
éjelen	éjjelen
éjelén	éjjelen
éjet	éjt
éjféltő	éjféltől
éjje	éjjel
éjjelenkint	éjjelenként
éjjelit	éjjelt
éjjfélkor	éjfélkor
éjszakról	északról
éjtszaka	éjszaka
ékszerbül	ékszerből
élebe	életbe
éledözni	éledezni
életböl	életből
életedvel	életeddel
életinek	életének
életje	élete
életjire	életére
életrű	életről
életyik	életük
életyikbe	életükbe
életyiket	életüket
életyinek	életének
életödnek	életednek
életöknek	életüknek
életöm	életem
életömet	életemet
életömöt	életemet
életü	életű
élhettök	élhettek
élire	élére
élit	élét
élivel	élével
éll	él
élletödnek	életednek
élniök	élniük
élök	élek
élös	éles
élőnk	élünk
élőtények	élőlények
énekelek	énekelek
éneköl	énekel
énekölgetni	énekelgetni
énekölnek	énekelnek
énekölt	énekelt
énekölte	énekelte
éneköltek	énekeltek
énelőttem	előttem
éngem	engem
éngemet	engem
énmellettem	mellettem
énmiattam	miattam
énneköm	énnekem
énnékem	énnekem
énrajtam	rajtam
énreám	rám
éntüllem	éntőlem
énvelem	velem
énvéllem	velem
énértem	értem
épen	éppen
éppeg	éppen
épségit	épségét
éptítőipar	építőipar
építnek	építenek
építötte	építette
épíőtipar	építőipar
épúgy	éppúgy
érbevételt	árbevételt
érdemlenétek	érdemelnétek
ére	erre
érette	érte
éretted	érted
érettem	értem
érettük	értük
éreztík	érezték
érgy	érj
érre	erre
értel	értesz
értékpapír-piac	értékpapírpiac
értékőzsde	értéktőzsde
értök	értük
értöttek	értettek
érvényös	érvényes
érébb	errébb
érékesítését	értékesítését
érëztem	éreztem
észak-amerikai	észak-amerikai
észak-keleten	északkeleten
északa	éjszaka
északről	északról
észreveszen	észrevesz
észrevétlenűl	észrevétlenül
észrevötte	észrevette
észrevötték	észrevették
étcaka	éjszaka
étekezel	étkezel
ételekbő	ételekből
ételëm	ételem
étessé	etess
étessék	etessék
éteti	eteti
étetni	etetni
étette	etette
étlen-szonnyan	étlen-szomjan
évforduól	évforduló
évtő	évtől
ëcaka	éjszaka
ëccaka	éjszaka
ëccër	egyszer
ëeggyik	egyik
ëegy	egy
ëggy	egy
ëggyik	egyik
ëgy	egy
ëgyënëst	egyenest
ël	el
ëmultam	elmúltam
ënnyi	ennyi
ërez	érez
ëri	éri
ës	és
ëstaóriát	históriát
ëstállóajtó	istállóajtó
ësz	esz
ëszik	eszik
ëszt	ezt
ët	őt
íbredtem	ébredtem
íccaka	éjszaka
ídesapjához	édesapjához
ífitájba	éjféltájba
ígek	égek
ígesd	égesd
ígesse	égesse
ígessem	égessem
ígett	égett
ígjen	égjen
ígnek	égnek
ígtek	égtek
ígyál	igyál
ígérté	ígértél
ígétt	égett
ígírtem	ígértem
ígízís	igézés
ígünk	égünk
ígő	égő
íhesebb	éhesebb
íhezem	éhezem
íhezzen	éhezzen
íhsíg	éhség
íjjel	éjjel
íjjeliszekrényre	éjjeliszekrényre
íjjelre	éjjelre
íl	él
ílek	élek
ílelmet	élelmet
íletbe	életbe
íletben	életben
íletednek	életednek
íletem	életem
íletemben	életemben
íletit	életét
ílettörténetit	élettörténetét
íletünknek	életünknek
ílhetsz	élhetsz
ílhetünk	élhetünk
íljen	éljen
íljetek	éljetek
íllek	illek
íllyen	ilyen
íllyet	ilyet
ílnek	élnek
ílni	élni
ílnének	élnének
íltek	éltek
ílével	élével
ílő	élő
ímhogy	ímhogy
ímé	íme
ínait	inait
ínni	inni
íntett	intett
ínég	még
ípen	épen
ípítenni	építeni
ípített	épített
ípítette	építette
ípítettek	építettek
ípítettem	építettem
ípíts	építs
ípítsen	építsen
ípíttetek	építettek
ípíttetett	építtetett
ípüllet	épület
ípülletben	épületben
ípülletet	épületet
ípülletre	épületre
ípülve	épülve
írezd	érezd
írezte	érezte
írje	érje
írjen	érjen
írkezett	érkezett
írkezik	érkezik
írkeznek	érkeznek
írkeztek	érkeztek
írkezzék	érkezzék
írkézett	érkezett
írnyi	írni
írte	érte
írted	érted
írtek	értek
írtem	értem
írtetek	értetek
írteti	érinti
írtette	értette
írtettem	értettem
írtík	érték
írtünk	értünk
írányban	irányban
írő	érő
ítel	étel
ítel-ital	étel-ital
ítelek	ételek
íteleket	ételeket
ítilték	ítélték
íztán	aztán
ízzó	izzó
ócsóbban	olcsóbban
ócsón	olcsón
ódala	oldala
ódalamot	oldalamat
ódalba	oldalba
ódalgott	oldalgott
ódalházba	oldalházba
ódalon	oldalon
ódalszoba	oldalszoba
ódalszobába	oldalszobába
ódalvarrásába	oldalvarrásába
ódalába	oldalába
ódalábúl	oldalából
ódalához	oldalához
ódaláná	oldalánál
ódalára	oldalára
ódalát	oldalát
ódja	oldja
ódjam	oldjam
ógy	úgy
óirás	óriás
ólónk	ólunk
óperenciás-tengeren	óperenciás-tenger
órakkor	órakor
órijás	óriás
óriás-szellem	óriásszellem
óriásokot	óriásokat
órjás	óriás
ót	olt
ótat	oltot
ótba	oltba
ótnak	oltnak
óton	olton
ótt	ott
ótvarat	ótvart
ótók	autók
óvad	olvad
öbreszteni	ébreszteni
öccsi	öccse
öccsinek	öccsének
öccsit	öccsét
ög	igen
ögyvez	özvegy
ögyél	egyél
öket	őket
öklelésibe	öklelésébe
öklivel	öklével
ökrihez	ökréhez
ökrököt	ökröket
ökröstűl	ökröstül
ökörbűl	ökörből
ökörhö	ökörhöz
ökörje	ökre
öleget	eleget
ölelgetyi	ölelgeti
öletnyi	öletni
ölibe	ölébe
öljík	öljék
öljítek	öljétek
öltözetü	öltözetű
ölégnek	elégnek
öncsëk	öntsék
önttettek	öntettek
ördöggye	ördöge
ördögt	ördögöt
ördöngősséget	ördöngösséget
ördöngősségre	ördöngösségre
öreg-rend	öregrend
öreganyámtul	öreganyámtól
öregapámtul	öregapámtól
öregapámtú	öregapámtól
öregasszon	öregasszony
öregasszonka	öregasszonyka
öregaszszony	öregasszony
öregbitik	öregbítik
öregektül	öregektől
öregembör	öregember
öregembörhöz	öregemberhez
öregembört	öregembert
öregségire	öregségére
öregök	öregek
öregöket	öregeket
öregöt	öreget
örendezett	örvendezett
örödögöt	ördögöt
örök-tartott	öröktartott
örökkös	örökös
örökétig	örökkétig
örömi	öröme
örömibe	örömébe
örömiben	örömében
örömire	örömére
örűlni	örülni
örűlt	örült
örűlünk	örülünk
örűt	örült
örűtek	örültek
ösmerném	ismerném
ösmert	ismert
ösmertem	ismertem
ösmertük	ismertük
ösmerëk	ismerek
össz-árbevétele	összárbevétel
összecsdült	összecsődült
összecsibbette	összecsípte
összedűl	összedől
összedűlt	összedőlt
összegyüjtött	összegyűjtött
összegyülnek	összegyűlnek
összegyüttek	összejöttek
összemarakodónk	összemarakodunk
összepakkolja	összepakolja
összeragatt	összeragadt
összeraktyák	összerakják
összeszedtík	összeszedték
összeszúrgálják	összeszurkálják
összetanákozik	összetalálkozik
összetanálkozott	összetalálkozott
összevarta	összevarrta
összevérözte	összevérezte
összeának	összeállnak
összeër	összeér
összeö	össze
összëmorizsgatod	összemorizsgatod
összëtörve	összetörve
ösvínyre	ösvényre
öszeszedik	összeszedik
öszik	eszik
ösznek	esznek
ötte	ette
ötték	ették
ötvel	öttel
ötyig	ötig
ötöd-kakasszókor	ötödkakasszókor
övezet-város	övezetváros
övött	evett
övős	evős
úccába	utcába
úcska	ócska
údvara	udvara
údvarra	udvarra
úgat	ugat
úgranak	ugranak
úgyahogy	úgy-ahogy
új-évkor	újévkor
úja	ujja
újad	ujjad
újbars	újbars
újbó	újból
újbúl	újból
újbút	újból
újhód	újhold
újhódkor	újholdkor
újj	ujj
újja	ujja
újjadda	ujjaddal
újjal	ujjal
újján	ujján
újját	ujját
újjával	ujjával
újjér	újért
újlag	újólag
újvároson	újvároson
újvárossra	újvárosra
úját	ujját
úra	ura
úrfelmutáskor	úrfelmutatáskor
úrhó	úrhoz
úrtúl	úrtól
úró	úrul
útadban	utadban
útadot	utadat
útak	utak
útat	utat
útazik	utazik
útaztak	utaztak
útazzunk	utazzunk
útazása	utazása
útazó	utazó
útcán	utcán
úthó	úthoz
útikőtséget	útiköltséget
útilevelet	útlevelet
útilevelét	útlevelét
útilevél	útlevél
útjok	útjuk
útjokat	útjukat
útjokban	útjukban
útjukot	útjukat
útjúkra	útjukra
útközbe	útközben
útni-verni	ütni-verni
útravaólt	útravalót
útszílben	útszélben
útszílen	útszélen
úttallat	utálat
üdeig	ideig
üdeje	ideje
üdes	édes
üdnepnapon	ünnepnapon
üdveért	üdvéért
üdvözletöt	üdvözletet
üdvözüőve	üdvözülve
üdvözűl	üdvözül
üdvüsségét	üdvösségét
üdő	idő
üdőbe	időbe
üdőben	időben
üdőket	időket
üdőkrül	időkről
üdőt	időt
üdőtőtést	időtöltést
üdővel	idővel
üdűbe	időbe
ügye	ugye
ügyekezett	igyekezett
ügyeközött	igyekezett
ügyesenn	ügyesen
ügyesön	ügyesen
ügyfél-megbízásokon	ügyfélmegbízásokon
ügyibe	ügyébe
ügyibevaló	ügyébevaló
üjjön	üljön
üjjünk	üljünk
ük	ők
üket	őket
üköt	őket
üldögéll	üldögél
ülete	ülepe
üljönek	üljenek
üllore	üllőre
üllyön	üljön
ülnyi	ülni
ültessítek	ültessétek
ültetnyi	ültetni
ültetík	ültetik
ültiben	ültében
ültömből	ültemből
ülőhelyiből	ülőhelyéből
ümög	ümög
üneki	őneki
ünge	inge
üregasszony	öregasszony
üsmerem	ismerem
üsmeretlen	ismeretlen
üszöget	üszköt
üszőborju	üszőborjú
ütet	őt
üthetyik	üthetik
ütte	ütötte
üttek	ütöttek
üttem	ütöttem
üttíl	ütöttél
ütyi-vágja	üti-vágja
ütöttkopott	ütött-kopott
üvegbő	üvegből
üveghegyrő	üveghegyről
üvegët	üvegét
üvegöcskét	üvegecskét
üvék	övék
üzemanyag-cellás	üzemanyagcellás
üzemanyag-kártyák	üzemanyagkártyák
üzletektül	üzletektől
üzletrész-eladásnak	üzletrészeladásnak
üzletág-vezető	üzletágvezető
üőt	őt
üőtöztetnek	öltöztetnek
őfelséges	őfelsége
őfelségit	őfelségét
őfőséginek	őfelségének
őkegyelmöket	őkegyelmüket
őkelminek	őkelmének
őkeme	őkelme
őkigyelme	őkegyelme
őkrőt	ökröt
őkígyelme	őkegyelme
őköt	őket
őllőt	őrlő
őlébe	ölébe
őmellöllök	őmellőlük
őnekijje	őneki
őnálok	őnáluk
őnéki	őneki
őreá	őrá
őrködéstek	őrködésetek
őrlenivaló	őrölnivaló
őrlenivalót	őrölnivalót
őrsíg	őrség
őrzened	őrizned
őrzesz	őrzöl
őrzötte	őrizte
őrzőköt	őrzőket
őrájok	őrájuk
őrízte	őrizte
őröszték	őrizték
őröz	őriz
őrözni	őrizni
őrözze	őrizze
őrözzenek	őrizzenek
őtem	öltem
őtöt	őt
őtöztesd	öltöztesd
őtöztetlek	öltöztetlek
őtöztették	öltöztették
őtözve	öltözve
őtözz	öltözz
őtözzem	öltözzem
őtözzék	öltözzék
őtözött	öltözött
ű	ő
űfeléjök	őfeléjük
űhozzá	őhozzá
űk	ők
űket	őket
űköt	őket
űl	ül
űlj	ülj
űlne	ülne
űlni	ülni
űlt	ült
űnek	ülnek
űneki	őneki
űnekije	őneki
űnekik	őnekik
űni	ülni
űnála	őnála
űrajta	őrajta
űtet	őt
űtetnek	ültetnek
űv	ő
űvé	övé
űvéllek	ővelük
